geoid,name,B07003001,"B07003001, Error",B07003002,"B07003002, Error",B07003003,"B07003003, Error",B07003004,"B07003004, Error",B07003005,"B07003005, Error",B07003006,"B07003006, Error",B07003007,"B07003007, Error",B07003008,"B07003008, Error",B07003009,"B07003009, Error",B07003010,"B07003010, Error",B07003011,"B07003011, Error",B07003012,"B07003012, Error",B07003013,"B07003013, Error",B07003014,"B07003014, Error",B07003015,"B07003015, Error",B07003016,"B07003016, Error",B07003017,"B07003017, Error",B07003018,"B07003018, Error"
01000US,United States,320984519,12103,157985702,9703,162998817,11328,275328008,182093,135064244,91984,140263764,96080,25736976,133956,12692364,66433,13044612,72434,10380509,44853,5389901,25022,4990608,24767,7475038,38666,3799158,20414,3675880,22226,2063988,17801,1040035,9061,1023953,11085
04000US12,Florida,20691583,2955,10113248,2801,10578335,2416,17479613,23723,8507345,13784,8972268,13018,1753656,19472,859791,10941,893865,10409,644456,8350,343295,4951,301161,4959,587748,10033,291709,5487,296039,5728,226110,6556,111108,3697,115002,3720
86000US32003,"32003",28564,1612,14221,997,14343,812,23356,1612,11544,1036,11812,748,1625,539,877,344,748,297,1616,667,888,433,728,345,1635,725,800,327,835,433,332,263,112,125,220,189
86000US32008,"32008",4326,776,2070,416,2256,445,4036,744,1981,398,2055,433,88,73,15,15,73,67,175,98,58,46,117,75,13,21,13,21,0,14,14,25,3,5,11,25
86000US32009,"32009",3573,289,1834,252,1739,186,3426,302,1773,254,1653,194,142,113,61,48,81,73,0,14,0,14,0,14,5,8,0,14,5,8,0,14,0,14,0,14
86000US32011,"32011",14359,845,6972,486,7387,507,13155,852,6376,491,6779,506,445,163,222,94,223,108,392,234,182,125,210,121,354,179,179,103,175,96,13,16,13,16,0,21
86000US32024,"32024",19190,1113,9302,651,9888,732,16686,1095,8033,658,8653,695,993,386,473,225,520,248,1007,408,448,254,559,212,503,234,347,159,156,107,1,3,1,3,0,21
86000US32025,"32025",23175,1183,13206,750,9969,677,16778,1073,9115,622,7663,680,2117,681,861,329,1256,391,3574,648,2763,444,811,274,637,247,431,203,206,96,69,64,36,35,33,39
86000US32026,"32026",2002,247,2002,247,0,14,1083,190,1083,190,0,14,0,14,0,14,0,14,904,150,904,150,0,14,15,22,15,22,0,14,0,14,0,14,0,14
86000US32033,"32033",4660,479,2376,358,2284,238,4070,438,2073,335,1997,229,280,186,116,82,164,120,99,99,29,44,70,89,107,129,54,65,53,64,104,68,104,68,0,14
86000US32034,"32034",36146,1196,17599,710,18547,738,31118,1380,14981,800,16137,802,2225,623,1080,340,1145,369,991,292,569,194,422,176,1807,485,969,261,838,259,5,9,0,29,5,9
86000US32038,"32038",10028,805,4892,451,5136,470,8675,747,4294,426,4381,433,600,350,241,146,359,223,525,208,298,144,227,113,193,149,46,37,147,137,35,41,13,21,22,35
86000US32040,"32040",7094,908,3701,489,3393,520,6376,882,3412,485,2964,495,329,201,134,91,195,122,304,229,148,119,156,127,85,80,7,11,78,77,0,19,0,19,0,19
86000US32043,"32043",26513,1078,13141,646,13372,821,22372,1285,10698,708,11674,797,1732,709,1088,501,644,260,1278,497,776,264,502,365,1106,803,579,448,527,462,25,44,0,25,25,44
86000US32044,"32044",1711,466,828,256,883,248,1626,454,813,254,813,235,28,32,4,7,24,31,57,74,11,20,46,56,0,14,0,14,0,14,0,14,0,14,0,14
86000US32046,"32046",9300,615,4474,371,4826,379,8114,618,3906,343,4208,397,832,287,451,177,381,134,142,80,75,49,67,55,212,132,42,40,170,104,0,19,0,19,0,19
86000US32052,"32052",9373,471,6095,284,3278,269,7543,474,4595,309,2948,299,299,158,130,95,169,89,1470,198,1341,184,129,110,61,39,29,21,32,27,0,19,0,19,0,19
86000US32053,"32053",3483,435,1681,256,1802,234,3112,400,1514,245,1598,214,228,220,106,120,122,105,132,121,52,54,80,77,11,18,9,18,2,5,0,14,0,14,0,14
86000US32054,"32054",11733,404,7103,316,4630,223,8849,483,4565,347,4284,234,374,151,198,80,176,88,2381,404,2232,394,149,77,127,56,107,62,20,23,2,5,1,3,1,2
86000US32055,"32055",16374,1099,8134,707,8240,566,13758,1132,6547,684,7211,578,1536,436,916,314,620,241,699,286,468,206,231,122,308,231,144,96,164,150,73,74,59,73,14,22
86000US32058,"32058",4282,509,2502,393,1780,240,3751,442,2067,339,1684,219,134,100,67,54,67,52,355,127,343,126,12,14,42,61,25,35,17,26,0,14,0,14,0,14
86000US32059,"32059",2405,443,1218,261,1187,249,2172,419,1094,259,1078,232,136,138,72,71,64,73,80,42,44,28,36,24,17,24,8,12,9,12,0,14,0,14,0,14
86000US32060,"32060",23870,1006,12148,656,11722,670,21770,1088,10899,646,10871,683,845,415,403,187,442,333,1091,487,776,375,315,170,163,113,69,55,94,73,1,3,1,3,0,25
86000US32061,"32061",514,371,256,169,258,213,361,225,191,119,170,120,0,14,0,14,0,14,153,228,65,96,88,133,0,14,0,14,0,14,0,14,0,14,0,14
86000US32062,"32062",1785,444,988,304,797,190,1640,427,900,298,740,186,0,14,0,14,0,14,145,140,88,122,57,48,0,14,0,14,0,14,0,14,0,14,0,14
86000US32063,"32063",13409,753,6769,547,6640,428,11246,852,5526,550,5720,466,802,374,454,237,348,197,1072,455,602,311,470,256,217,173,187,153,30,33,72,95,0,21,72,95
86000US32064,"32064",6779,96,3760,311,3019,333,5623,433,3041,408,2582,347,404,251,243,214,161,115,602,318,337,162,265,164,133,120,122,116,11,16,17,44,17,44,0,19
86000US32065,"32065",36923,1933,17449,998,19474,1229,30247,1825,14188,1058,16059,1107,2476,927,1240,557,1236,460,2386,838,1259,446,1127,479,1541,623,653,317,888,370,273,271,109,120,164,162
86000US32066,"32066",7371,452,4571,357,2800,308,6225,536,3616,388,2609,336,239,217,142,159,97,85,849,221,785,199,64,79,29,34,11,18,18,26,29,34,17,28,12,21
86000US32068,"32068",56602,2559,28974,1601,27628,1280,48248,2386,24843,1415,23405,1255,3265,925,1774,576,1491,542,2675,759,1325,423,1350,450,2272,844,934,422,1338,493,142,124,98,107,44,51
86000US32071,"32071",3903,655,2068,399,1835,347,3687,658,1945,395,1742,347,30,25,13,17,17,20,145,120,90,82,55,58,26,24,20,18,6,9,15,35,0,14,15,35
86000US32072,"32072",211,148,55,46,156,129,154,99,55,46,99,64,0,14,0,14,0,14,0,14,0,14,0,14,57,86,0,14,57,86,0,14,0,14,0,14
86000US32073,"32073",42030,1416,20412,932,21618,998,32404,1643,15949,1066,16455,894,3033,846,1379,448,1654,509,4381,1021,1877,489,2504,631,1783,546,1012,347,771,270,429,321,195,167,234,185
86000US32079,"32079",451,123,199,72,252,88,374,125,149,68,225,89,19,19,4,10,15,21,49,43,46,42,3,5,9,18,0,14,9,18,0,14,0,14,0,14
86000US32080,"32080",22077,763,11080,553,10997,553,18852,941,9347,579,9505,536,1620,453,849,258,771,262,593,227,278,143,315,118,842,289,494,247,348,129,170,107,112,77,58,51
86000US32081,"32081",14698,1433,7497,932,7201,716,11627,1194,5811,748,5816,589,1101,641,794,584,307,161,496,257,342,179,154,93,1401,618,530,322,871,398,73,85,20,38,53,57
86000US32082,"32082",30319,1124,14532,666,15787,698,25710,1086,12503,628,13207,649,1399,387,655,217,744,210,1493,454,762,277,731,255,1348,386,450,159,898,275,369,238,162,121,207,122
86000US32083,"32083",4070,616,3399,602,671,120,3113,524,2488,515,625,119,81,67,62,63,19,22,846,197,819,195,27,22,30,38,30,38,0,14,0,14,0,14,0,14
86000US32084,"32084",35398,1439,16278,1019,19120,898,27852,1335,12563,890,15289,878,2966,719,1467,401,1499,395,2382,533,1258,350,1124,303,1924,454,856,262,1068,295,274,179,134,92,140,102
86000US32086,"32086",29206,1260,13694,719,15512,890,24443,1314,11696,699,12747,867,2406,674,1079,322,1327,441,1187,460,424,216,763,288,1107,389,462,222,645,257,63,108,33,57,30,51
86000US32087,"32087",6959,839,3925,558,3034,522,4779,875,2402,449,2377,555,667,618,262,226,405,423,1474,416,1222,347,252,182,23,28,23,28,0,19,16,28,16,28,0,19
86000US32091,"32091",15229,818,7381,590,7848,453,13811,928,6663,626,7148,527,466,268,248,169,218,136,731,295,377,177,354,157,205,189,93,109,112,103,16,27,0,21,16,27
86000US32092,"32092",36950,2203,18514,1526,18436,1258,30628,2158,15275,1321,15353,1326,1444,646,799,410,645,320,2757,1174,1365,637,1392,602,1790,900,788,421,1002,581,331,413,287,340,44,76
86000US32094,"32094",2550,572,1296,289,1254,370,2239,552,1089,271,1150,364,63,61,37,32,26,31,203,104,148,69,55,63,45,35,22,19,23,27,0,14,0,14,0,14
86000US32095,"32095",11576,1241,5938,753,5638,829,8819,1213,4278,610,4541,843,1330,852,887,624,443,256,574,323,362,244,212,190,784,397,389,199,395,215,69,112,22,36,47,77
86000US32096,"32096",2186,329,1023,176,1163,216,2014,301,987,173,1027,181,79,98,18,20,61,83,90,52,15,15,75,50,2,5,2,5,0,14,1,3,1,3,0,14
86000US32097,"32097",18836,958,9807,715,9029,521,15830,1082,8066,753,7764,563,1257,446,746,302,511,198,922,434,475,246,447,213,686,310,429,266,257,125,141,142,91,95,50,60
86000US32102,"32102",2283,444,1125,243,1158,262,2098,409,1024,234,1074,247,86,65,44,49,42,43,61,65,38,40,23,26,38,46,19,21,19,29,0,14,0,14,0,14
86000US32110,"32110",8205,598,3944,366,4261,398,7064,668,3374,407,3690,399,540,197,328,128,212,84,285,152,100,55,185,122,272,198,111,90,161,121,44,61,31,42,13,22
86000US32112,"32112",7501,750,3611,410,3890,466,6583,728,3088,372,3495,470,585,217,349,133,236,105,148,90,65,45,83,59,185,128,109,82,76,53,0,19,0,19,0,19
86000US32113,"32113",5170,812,2713,545,2457,408,4731,766,2448,517,2283,382,116,77,82,69,34,47,170,180,133,168,37,47,143,139,50,48,93,105,10,19,0,19,10,19
86000US32114,"32114",32430,951,15422,769,17008,772,25088,1194,11970,809,13118,840,3693,740,1676,389,2017,489,1891,434,791,248,1100,313,1494,518,911,357,583,224,264,154,74,58,190,150
86000US32117,"32117",26203,1141,13272,859,12931,706,22988,1288,11604,876,11384,765,1557,473,796,292,761,266,783,206,470,170,313,123,705,301,308,154,397,195,170,101,94,97,76,58
86000US32118,"32118",17330,829,8630,608,8700,653,14214,937,7198,597,7016,616,1678,434,736,218,942,348,521,223,214,105,307,149,736,193,393,143,343,128,181,188,89,101,92,91
86000US32119,"32119",22127,564,10767,480,11360,504,18462,705,8816,467,9646,534,1964,391,1040,261,924,220,649,265,423,202,226,119,853,268,385,156,468,162,199,105,103,66,96,76
86000US32124,"32124",6060,820,3917,709,2143,278,4856,606,3022,499,1834,254,612,182,458,170,154,63,381,324,337,322,44,35,201,128,100,70,101,67,10,17,0,19,10,17
86000US32127,"32127",30120,1079,14313,727,15807,733,26491,1006,12679,709,13812,638,2250,588,1020,296,1230,356,675,375,268,185,407,203,639,219,296,120,343,130,65,81,50,77,15,24
86000US32128,"32128",20840,1002,10288,813,10552,631,18270,1104,9194,771,9076,646,1670,654,582,204,1088,542,301,158,213,122,88,90,401,245,206,126,195,138,198,166,93,80,105,88
86000US32129,"32129",22149,1052,10699,719,11450,630,18461,1131,8709,710,9752,644,1904,517,1106,351,798,270,590,397,320,232,270,180,861,286,431,167,430,163,333,183,133,89,200,117
86000US32130,"32130",5603,749,2573,326,3030,501,4872,678,2230,331,2642,424,295,201,188,130,107,78,109,131,49,59,60,78,42,41,17,19,25,24,285,452,89,133,196,320
86000US32131,"32131",4317,478,2377,336,1940,258,3874,390,2060,251,1814,240,44,35,36,38,8,13,310,149,229,128,81,52,89,127,52,78,37,51,0,14,0,14,0,14
86000US32132,"32132",7506,493,3299,274,4207,368,6802,532,3011,306,3791,364,470,162,156,65,314,118,134,95,76,59,58,56,83,61,56,47,27,24,17,21,0,19,17,21
86000US32133,"32133",17,38,9,19,8,20,17,38,9,19,8,20,0,14,0,14,0,14,0,14,0,14,0,14,0,14,0,14,0,14,0,14,0,14,0,14
86000US32134,"32134",7737,851,4072,509,3665,477,6941,851,3628,478,3313,483,111,68,62,46,49,35,491,246,251,148,240,149,164,106,119,84,45,37,30,36,12,17,18,19
86000US32136,"32136",8230,302,3983,241,4247,258,6982,353,3499,264,3483,222,309,150,170,84,139,79,417,178,150,88,267,117,406,147,127,57,279,111,116,125,37,58,79,88
86000US32137,"32137",43733,1121,21063,797,22670,636,38438,1110,18334,773,20104,640,1147,309,575,181,572,183,1323,457,604,329,719,222,2321,505,1248,330,1073,246,504,437,302,269,202,171
86000US32139,"32139",938,305,488,167,450,175,914,303,475,161,439,174,24,21,13,23,11,17,0,14,0,14,0,14,0,14,0,14,0,14,0,14,0,14,0,14
86000US32140,"32140",1439,390,691,223,748,218,1224,324,582,178,642,198,145,215,93,151,52,67,61,62,16,29,45,43,0,14,0,14,0,14,9,14,0,14,9,14
86000US32141,"32141",18792,657,9213,495,9579,498,15964,852,7833,497,8131,551,1328,610,539,303,789,348,593,293,414,214,179,122,687,280,259,119,428,202,220,301,168,252,52,57
86000US32145,"32145",5696,482,2956,313,2740,336,4695,602,2444,342,2251,397,367,192,182,97,185,116,538,278,265,119,273,197,91,65,65,62,26,30,5,8,0,19,5,8
86000US32147,"32147",790,633,410,306,380,353,407,273,236,159,171,159,242,368,97,148,145,220,141,216,77,117,64,100,0,14,0,14,0,14,0,14,0,14,0,14
86000US32148,"32148",10490,995,5318,617,5172,555,9199,992,4645,553,4554,588,574,300,399,251,175,99,476,223,233,136,243,152,241,191,41,35,200,187,0,21,0,21,0,21
86000US32157,"32157",363,206,176,109,187,110,363,206,176,109,187,110,0,14,0,14,0,14,0,14,0,14,0,14,0,14,0,14,0,14,0,14,0,14,0,14
86000US32159,"32159",29803,950,13815,658,15988,653,25441,1047,11983,664,13458,668,1346,417,648,215,698,264,1126,400,363,142,763,328,1811,358,801,212,1010,261,79,67,20,24,59,50
86000US32162,"32162",54919,2009,25329,998,29590,1272,51602,2003,23893,1060,27709,1205,977,514,391,206,586,372,643,388,384,304,259,181,1519,540,526,231,993,378,178,145,135,118,43,49
86000US32164,"32164",47045,1007,22202,806,24843,691,41607,1135,19703,804,21904,703,1869,496,782,270,1087,307,1106,348,549,228,557,198,2199,502,1035,284,1164,278,264,177,133,124,131,72
86000US32168,"32168",27579,1075,13262,753,14317,801,23683,1143,11252,651,12431,842,1727,468,844,249,883,303,859,326,453,183,406,184,1186,323,628,237,558,170,124,135,85,130,39,38
86000US32169,"32169",10155,731,4566,324,5589,524,8493,728,3863,307,4630,513,594,170,258,103,336,152,377,116,135,54,242,93,657,213,297,137,360,119,34,30,13,14,21,18
86000US32174,"32174",50806,1121,24711,899,26095,774,44506,1674,21976,1067,22530,988,3800,902,1674,478,2126,534,1262,402,508,184,754,271,1149,386,479,175,670,238,89,64,74,60,15,23
86000US32176,"32176",14401,746,6828,395,7573,532,12684,692,6055,387,6629,487,651,219,317,145,334,116,511,180,287,114,224,81,484,183,134,73,350,138,71,45,35,25,36,27
86000US32177,"32177",26720,1088,12500,656,14220,693,23346,1146,10749,660,12597,724,2085,624,1090,336,995,348,811,296,464,162,347,169,427,222,178,103,249,137,51,54,19,28,32,44
86000US32179,"32179",7893,1103,3636,491,4257,782,7095,1102,3239,518,3856,771,286,169,95,66,191,139,253,186,156,120,97,88,259,284,146,140,113,147,0,19,0,19,0,19
86000US32180,"32180",4510,684,2568,461,1942,336,4371,677,2484,458,1887,333,69,60,41,40,28,26,55,51,36,42,19,24,10,11,7,10,3,4,5,8,0,14,5,8
86000US32181,"32181",2553,536,1197,285,1356,331,2384,510,1125,282,1259,315,105,54,44,29,61,40,50,43,14,21,36,37,2,6,2,6,0,14,12,18,12,18,0,14
86000US32187,"32187",1871,422,961,246,910,269,1818,417,927,244,891,269,20,30,20,30,0,14,33,38,14,23,19,30,0,14,0,14,0,14,0,14,0,14,0,14
86000US32189,"32189",5874,810,3105,491,2769,441,5059,783,2631,428,2428,456,480,428,285,280,195,177,259,183,150,101,109,87,76,65,39,32,37,33,0,19,0,19,0,19
86000US32190,"32190",1309,512,543,207,766,361,1272,512,530,207,742,361,37,42,13,19,24,27,0,14,0,14,0,14,0,14,0,14,0,14,0,14,0,14,0,14
86000US32193,"32193",679,224,302,113,377,121,576,192,260,94,316,107,68,58,32,32,36,29,24,18,8,11,16,13,11,9,2,4,9,7,0,14,0,14,0,14
86000US32195,"32195",2926,581,1256,320,1670,332,2549,479,1111,283,1438,290,192,142,69,64,123,97,185,189,76,84,109,118,0,14,0,14,0,14,0,14,0,14,0,14
86000US32202,"32202",6478,530,3973,313,2505,358,3162,368,1796,222,1366,257,2571,422,1693,258,878,251,426,153,312,122,114,75,271,127,164,74,107,74,48,64,8,15,40,61
86000US32204,"32204",7531,774,3468,441,4063,530,5563,697,2476,340,3087,488,1274,382,657,238,617,240,282,157,145,91,137,123,411,192,190,101,221,120,1,3,0,19,1,3
86000US32205,"32205",29635,1319,14213,850,15422,836,23440,1245,11197,767,12243,783,4049,697,2125,413,1924,367,1198,422,472,196,726,257,816,310,331,146,485,231,132,97,88,79,44,32
86000US32206,"32206",15867,919,7567,650,8300,563,12085,801,5649,547,6436,514,2923,623,1386,343,1537,386,504,152,300,80,204,111,340,214,226,193,114,65,15,16,6,10,9,11
86000US32207,"32207",35126,1384,17479,876,17647,977,29638,1419,14780,942,14858,854,3779,718,1871,432,1908,437,732,257,368,149,364,170,521,221,376,194,145,71,456,402,84,79,372,386
86000US32208,"32208",30557,1583,13410,831,17147,1087,24919,1488,10727,758,14192,1041,4645,1061,2202,542,2443,616,534,267,221,157,313,164,437,231,260,151,177,108,22,39,0,29,22,39
86000US32209,"32209",34439,1469,16216,948,18223,933,26632,1439,12807,918,13825,819,6452,1001,2760,449,3692,669,498,221,195,95,303,166,857,355,454,211,403,191,0,29,0,29,0,29
86000US32210,"32210",61026,1800,29322,1177,31704,1080,51692,1835,24969,1131,26723,1077,7056,1137,3175,669,3881,578,815,218,521,162,294,132,1103,309,517,202,586,190,360,240,140,109,220,144
86000US32211,"32211",34990,1529,16748,1032,18242,951,26142,1402,12304,882,13838,834,7172,1188,3484,708,3688,661,524,242,337,213,187,101,877,363,467,195,410,197,275,148,156,93,119,88
86000US32212,"32212",2434,311,1664,283,770,222,1657,333,1164,290,493,167,74,68,32,35,42,41,108,71,67,43,41,41,552,189,358,172,194,130,43,49,43,49,0,14
86000US32216,"32216",37736,1691,17555,966,20181,1267,28904,1474,13175,887,15729,991,5531,1072,2634,571,2897,643,1096,342,499,166,597,223,1019,398,607,282,412,200,1186,771,640,408,546,563
86000US32217,"32217",19595,970,9441,676,10154,700,16176,948,7523,608,8653,685,2078,524,1198,329,880,298,594,350,305,213,289,213,557,275,317,171,240,164,190,183,98,126,92,68
86000US32218,"32218",63178,2451,30457,1705,32721,1408,51789,2241,24481,1452,27308,1337,7468,1550,3929,902,3539,817,1539,543,774,293,765,329,2253,692,1209,437,1044,360,129,108,64,60,65,56
86000US32219,"32219",12519,1667,6421,973,6098,885,10765,1553,5388,895,5377,848,1487,758,831,424,656,359,111,111,102,110,9,20,124,102,68,66,56,47,32,40,32,40,0,21
86000US32220,"32220",12790,1095,6391,576,6399,719,11115,1056,5560,610,5555,624,1487,682,785,336,702,406,44,51,13,22,31,35,144,116,33,40,111,101,0,21,0,21,0,21
86000US32221,"32221",30473,1561,14712,916,15761,1071,24733,1525,11977,837,12756,992,3781,931,1726,555,2055,541,1285,729,619,362,666,412,568,253,346,155,222,144,106,129,44,74,62,78
86000US32222,"32222",11335,1249,5392,659,5943,804,8944,1040,4178,574,4766,658,1251,460,596,216,655,262,507,312,314,229,193,103,598,387,283,175,315,252,35,45,21,24,14,24
86000US32223,"32223",24360,715,12273,586,12087,457,22080,767,11023,559,11057,497,1283,332,714,205,569,175,518,240,277,132,241,135,459,221,239,119,220,133,20,22,20,22,0,25
86000US32224,"32224",43533,2239,20255,1509,23278,1178,34411,2326,15988,1453,18423,1195,4059,684,2052,470,2007,410,2204,553,1063,295,1141,369,1674,710,679,274,995,533,1185,663,473,258,712,455
86000US32225,"32225",54315,1820,26064,1001,28251,1195,45978,1847,21826,1000,24152,1209,5893,1037,2909,499,2984,666,901,343,488,207,413,185,1171,333,654,218,517,171,372,149,187,99,185,88
86000US32226,"32226",15457,967,7946,496,7511,681,13095,979,6750,493,6345,659,1271,447,673,299,598,191,379,230,203,126,176,153,669,286,302,155,367,145,43,54,18,36,25,40
86000US32227,"32227",3301,717,2171,519,1130,248,1819,433,1248,340,571,152,142,114,71,58,71,60,351,293,216,187,135,140,891,319,614,246,277,115,98,76,22,23,76,63
86000US32228,"32228",470,305,407,247,63,63,188,110,178,93,10,20,0,14,0,14,0,14,99,114,77,74,22,45,183,162,152,143,31,29,0,14,0,14,0,14
86000US32233,"32233",24802,787,13036,600,11766,571,20580,863,10792,579,9788,594,2225,546,1217,356,1008,293,618,197,291,111,327,126,1256,320,663,184,593,200,123,95,73,65,50,45
86000US32234,"32234",5767,650,2874,410,2893,350,4667,547,2378,363,2289,277,436,248,200,121,236,132,351,186,164,104,187,107,297,282,116,105,181,183,16,25,16,25,0,19
86000US32244,"32244",58153,2377,27960,1422,30193,1357,48555,2203,23478,1246,25077,1324,6214,1157,2931,717,3283,675,1549,617,654,371,895,363,1602,473,802,282,800,284,233,155,95,76,138,133
86000US32246,"32246",51018,2385,24838,1385,26180,1533,40331,2325,19632,1297,20699,1383,6916,1415,3149,767,3767,829,1084,445,737,362,347,183,1780,657,956,380,824,350,907,578,364,352,543,403
86000US32250,"32250",27015,595,13931,563,13084,619,22551,718,11635,569,10916,582,3006,681,1622,393,1384,337,728,266,378,154,350,159,611,223,249,94,362,182,119,143,47,61,72,90
86000US32254,"32254",13217,912,6079,461,7138,638,10542,837,4708,413,5834,623,1955,458,905,227,1050,302,208,126,183,122,25,27,465,329,236,166,229,171,47,48,47,48,0,21
86000US32256,"32256",47215,2065,22704,1333,24511,1299,34067,1989,16375,1158,17692,1146,8194,1423,3954,776,4240,931,1384,465,668,211,716,325,2860,613,1410,327,1450,403,710,382,297,198,413,208
86000US32257,"32257",38335,1154,18705,760,19630,708,33047,1115,16064,748,16983,633,3616,809,1826,472,1790,404,633,253,412,196,221,103,475,177,208,101,267,119,564,364,195,166,369,242
86000US32258,"32258",33353,1938,16566,1348,16787,1165,27811,2042,13709,1259,14102,1188,3202,971,1627,558,1575,576,1148,524,511,346,637,297,1015,477,719,359,296,189,177,145,0,29,177,145
86000US32259,"32259",51799,1339,25022,875,26777,957,43749,1323,21258,841,22491,946,2084,577,840,243,1244,405,2765,635,1403,360,1362,364,2891,786,1377,365,1514,512,310,190,144,98,166,117
86000US32266,"32266",7044,332,3373,254,3671,283,6231,410,3000,261,3231,279,613,352,328,217,285,159,116,92,0,19,116,92,84,60,45,37,39,35,0,19,0,19,0,19
86000US32277,"32277",31813,1493,14647,904,17166,1078,25880,1444,12274,855,13606,972,4691,974,1790,420,2901,676,444,179,220,105,224,116,648,248,269,134,379,153,150,112,94,106,56,32
86000US32301,"32301",30993,1166,13731,769,17262,750,21251,1097,9580,680,11671,713,5288,657,2405,422,2883,420,2833,591,1110,309,1723,383,1321,346,544,185,777,235,300,107,92,61,208,81
86000US32303,"32303",47811,1634,23394,971,24417,1136,38233,1318,18905,861,19328,823,5801,824,2698,482,3103,549,2257,588,1122,328,1135,345,1382,383,597,218,785,248,138,107,72,78,66,80
86000US32304,"32304",49808,1875,24112,1305,25696,1343,23837,1561,11517,993,12320,1005,14158,1211,6879,745,7279,903,9220,1044,4202,651,5018,704,2102,429,1261,307,841,262,491,160,253,112,238,103
86000US32305,"32305",20626,1142,9826,649,10800,796,17493,1140,8245,604,9248,772,1701,443,881,271,820,302,1102,410,531,202,571,291,250,167,134,117,116,105,80,99,35,62,45,59
86000US32308,"32308",21826,1072,9488,663,12338,711,17121,1095,7415,651,9706,669,3060,694,1240,351,1820,468,745,230,334,133,411,149,650,210,349,117,301,126,250,172,150,110,100,79
86000US32309,"32309",31300,1197,14893,789,16407,705,27527,1062,12860,690,14667,644,2158,589,1271,440,887,237,622,261,356,160,266,137,785,315,315,147,470,243,208,162,91,78,117,97
86000US32310,"32310",15437,1182,7113,745,8324,722,11808,1058,5189,562,6619,725,1822,469,856,249,966,290,1515,584,949,415,566,224,235,113,70,47,165,97,57,49,49,46,8,16
86000US32311,"32311",22015,866,10243,591,11772,572,18502,928,8602,603,9900,517,2128,520,1106,328,1022,316,548,267,298,161,250,158,832,239,237,100,595,180,5,12,0,25,5,12
86000US32312,"32312",32383,1173,15800,840,16583,706,28166,1192,13810,801,14356,651,2767,814,1292,357,1475,533,823,376,356,158,467,246,556,336,301,236,255,133,71,65,41,41,30,32
86000US32317,"32317",14738,910,7451,609,7287,491,12796,867,6548,540,6248,517,955,273,429,150,526,164,294,185,126,133,168,111,545,391,285,176,260,229,148,116,63,58,85,68
86000US32320,"32320",3887,370,1972,267,1915,193,3484,356,1690,260,1794,190,187,157,131,113,56,49,144,72,116,60,28,30,70,47,34,25,36,30,2,4,1,2,1,2
86000US32321,"32321",6257,303,3849,352,2408,276,5279,356,3073,357,2206,283,156,114,47,37,109,100,804,191,713,171,91,52,13,16,13,16,0,19,5,7,3,5,2,3
86000US32322,"32322",3950,243,2760,202,1190,176,2731,342,1797,228,934,183,267,215,120,77,147,150,835,177,758,164,77,46,111,84,82,72,29,27,6,8,3,6,3,6
86000US32323,"32323",137,83,63,50,74,46,137,83,63,50,74,46,0,14,0,14,0,14,0,14,0,14,0,14,0,14,0,14,0,14,0,14,0,14,0,14
86000US32324,"32324",4716,307,2604,277,2112,247,3899,352,1963,256,1936,253,149,80,85,49,64,56,651,213,548,182,103,69,17,20,8,14,9,14,0,14,0,14,0,14
86000US32327,"32327",28319,626,15738,397,12581,416,24673,734,13104,490,11569,467,1142,343,715,225,427,172,2160,393,1763,308,397,172,254,137,123,84,131,89,90,76,33,39,57,63
86000US32328,"32328",3396,399,1680,254,1716,203,3121,403,1538,257,1583,209,86,67,31,30,55,53,91,44,72,35,19,18,95,60,36,34,59,46,3,6,3,6,0,14
86000US32330,"32330",651,239,312,141,339,128,558,203,262,121,296,115,83,110,50,69,33,42,0,14,0,14,0,14,10,16,0,14,10,16,0,14,0,14,0,14
86000US32331,"32331",4192,492,2050,308,2142,276,3862,506,1899,315,1963,269,79,72,32,35,47,58,180,98,81,50,99,75,71,83,38,44,33,39,0,14,0,14,0,14
86000US32332,"32332",1077,315,506,192,571,168,965,277,425,170,540,151,54,82,32,47,22,36,46,51,46,51,0,14,12,20,3,6,9,19,0,14,0,14,0,14
86000US32333,"32333",11282,944,5768,618,5514,532,10459,850,5282,530,5177,507,182,134,84,79,98,78,619,206,383,170,236,117,18,25,15,21,3,8,4,6,4,6,0,21
86000US32334,"32334",2009,299,1075,197,934,171,1933,304,1040,196,893,169,23,39,23,39,0,14,46,49,5,9,41,42,7,10,7,10,0,14,0,14,0,14,0,14
86000US32336,"32336",1108,299,573,178,535,142,1012,290,503,167,509,143,23,37,11,17,12,22,73,68,59,61,14,18,0,14,0,14,0,14,0,14,0,14,0,14
86000US32340,"32340",11314,649,6287,379,5027,400,9440,724,5037,433,4403,422,670,238,253,112,417,151,1044,207,885,150,159,99,56,41,19,19,37,33,104,101,93,102,11,18
86000US32343,"32343",3188,51,1510,151,1678,160,3064,96,1433,155,1631,159,28,33,17,23,11,13,35,33,30,29,5,8,61,73,30,50,31,28,0,14,0,14,0,14
86000US32344,"32344",12234,378,6429,241,5805,211,10213,497,4908,331,5305,256,384,186,169,93,215,113,1351,183,1202,174,149,72,240,174,119,95,121,86,46,43,31,30,15,17
86000US32346,"32346",1933,431,1007,253,926,237,1812,434,947,257,865,237,50,35,9,13,41,29,18,30,18,30,0,14,53,64,33,38,20,31,0,14,0,14,0,14
86000US32347,"32347",7496,515,3635,386,3861,282,6731,474,3228,336,3503,289,437,230,257,145,180,111,194,135,102,83,92,75,69,85,0,19,69,85,65,57,48,51,17,27
86000US32348,"32348",12848,579,7896,439,4952,298,10108,559,5674,414,4434,298,549,302,302,195,247,130,2104,408,1891,278,213,168,64,53,29,30,35,41,23,36,0,21,23,36
86000US32350,"32350",1272,318,652,181,620,169,1218,302,636,179,582,154,22,26,16,19,6,10,26,39,0,14,26,39,6,9,0,14,6,9,0,14,0,14,0,14
86000US32351,"32351",18461,938,8048,535,10413,609,16175,1000,7113,550,9062,647,540,283,286,161,254,144,1686,285,643,181,1043,162,60,41,6,11,54,38,0,21,0,21,0,21
86000US32352,"32352",6117,884,2865,521,3252,490,5748,944,2633,540,3115,511,283,234,146,135,137,112,61,85,61,85,0,19,25,38,25,38,0,19,0,19,0,19,0,19
86000US32355,"32355",240,87,119,51,121,46,240,87,119,51,121,46,0,14,0,14,0,14,0,14,0,14,0,14,0,14,0,14,0,14,0,14,0,14,0,14
86000US32356,"32356",0,14,0,14,0,14,0,14,0,14,0,14,0,14,0,14,0,14,0,14,0,14,0,14,0,14,0,14,0,14,0,14,0,14,0,14
86000US32358,"32358",2002,497,809,225,1193,327,1927,487,766,220,1161,323,64,75,38,42,26,36,2,4,2,4,0,14,2,3,0,14,2,3,7,13,3,5,4,8
86000US32359,"32359",1271,392,682,213,589,201,1230,392,668,213,562,202,0,14,0,14,0,14,15,23,0,14,15,23,26,45,14,24,12,21,0,14,0,14,0,14
86000US32361,"32361",383,190,215,127,168,98,383,190,215,127,168,98,0,14,0,14,0,14,0,14,0,14,0,14,0,14,0,14,0,14,0,14,0,14,0,14
86000US32399,"32399",0,14,0,14,0,14,0,14,0,14,0,14,0,14,0,14,0,14,0,14,0,14,0,14,0,14,0,14,0,14,0,14,0,14,0,14
86000US32401,"32401",21866,1163,10783,770,11083,683,16870,1051,8101,684,8769,628,3353,709,1633,407,1720,418,378,135,203,76,175,79,1039,578,638,398,401,208,226,199,208,198,18,28
86000US32403,"32403",2705,341,1542,228,1163,164,1497,298,845,207,652,129,161,134,86,77,75,61,87,54,67,39,20,21,890,214,511,134,379,113,70,73,33,38,37,41
86000US32404,"32404",38891,1445,20074,910,18817,797,29371,1685,15028,906,14343,980,5769,974,3016,557,2753,600,1566,602,838,339,728,340,2036,695,1124,446,912,305,149,88,68,57,81,68
86000US32405,"32405",31734,1263,15268,754,16466,842,24846,1317,12108,726,12738,827,5421,860,2310,421,3111,585,555,345,311,252,244,142,800,332,478,224,322,155,112,106,61,54,51,63
86000US32407,"32407",10701,685,5422,400,5279,430,7865,666,3912,390,3953,366,1557,404,756,213,801,230,135,87,104,76,31,27,1060,340,596,211,464,226,84,73,54,50,30,33
86000US32408,"32408",18470,923,9236,602,9234,580,15054,929,7458,553,7596,605,2342,528,1290,321,1052,256,290,153,136,86,154,92,718,277,343,127,375,189,66,57,9,13,57,56
86000US32409,"32409",10097,874,4894,503,5203,513,9098,838,4443,476,4655,501,730,342,339,141,391,228,117,88,56,46,61,49,152,173,56,94,96,84,0,21,0,21,0,21
86000US32410,"32410",964,134,477,78,487,78,766,125,398,73,368,69,59,37,26,19,33,20,15,13,6,7,9,9,121,61,44,29,77,39,3,6,3,6,0,14
86000US32413,"32413",14590,896,7398,512,7192,552,11965,874,5971,509,5994,524,909,381,442,215,467,188,361,141,157,80,204,85,1355,397,828,268,527,201,0,21,0,21,0,21
86000US32420,"32420",1945,315,1001,201,944,170,1627,296,842,196,785,158,210,96,106,52,104,54,69,61,33,32,36,35,39,43,20,23,19,21,0,14,0,14,0,14
86000US32421,"32421",4765,579,2442,336,2323,307,4296,556,2214,342,2082,289,74,69,55,61,19,25,294,163,123,82,171,92,101,86,50,47,51,47,0,14,0,14,0,14
86000US32423,"32423",966,232,520,133,446,113,875,218,463,118,412,114,11,12,8,11,3,5,6,10,6,10,0,14,74,95,43,56,31,39,0,14,0,14,0,14
86000US32424,"32424",7469,480,4382,337,3087,312,5786,518,3207,383,2579,264,459,231,195,109,264,158,966,216,867,185,99,89,229,190,100,83,129,114,29,44,13,20,16,25
86000US32425,"32425",13423,611,7306,404,6117,319,10627,797,5500,469,5127,405,1002,438,493,258,509,213,1495,326,1150,228,345,131,299,164,163,91,136,92,0,21,0,21,0,21
86000US32426,"32426",797,158,387,93,410,92,747,143,372,92,375,74,2,3,0,14,2,3,48,70,15,23,33,47,0,14,0,14,0,14,0,14,0,14,0,14
86000US32427,"32427",1016,231,478,133,538,145,876,220,412,127,464,138,65,65,18,26,47,49,74,50,48,40,26,27,0,14,0,14,0,14,1,2,0,14,1,2
86000US32428,"32428",17454,606,9945,415,7509,317,14617,693,7935,441,6682,366,653,296,207,109,446,199,1970,333,1668,245,302,154,212,101,135,90,77,45,2,5,0,21,2,5
86000US32430,"32430",1160,357,630,215,530,174,1059,338,590,207,469,162,92,145,40,63,52,84,9,14,0,14,9,14,0,14,0,14,0,14,0,14,0,14,0,14
86000US32431,"32431",4091,395,2015,229,2076,227,3533,409,1758,224,1775,224,227,109,113,61,114,66,208,134,81,77,127,74,123,127,63,90,60,53,0,14,0,14,0,14
86000US32432,"32432",0,14,0,14,0,14,0,14,0,14,0,14,0,14,0,14,0,14,0,14,0,14,0,14,0,14,0,14,0,14,0,14,0,14,0,14
86000US32433,"32433",17623,1012,9772,546,7851,668,14716,1021,7924,586,6792,592,1232,493,739,347,493,233,1068,239,873,184,195,118,593,284,236,155,357,211,14,23,0,21,14,23
86000US32435,"32435",7404,690,3537,419,3867,398,5996,676,2937,419,3059,351,1078,407,438,190,640,251,145,89,84,53,61,53,185,125,78,75,107,68,0,19,0,19,0,19
86000US32437,"32437",839,274,417,150,422,142,663,201,360,125,303,112,157,174,52,58,105,116,19,20,5,6,14,20,0,14,0,14,0,14,0,14,0,14,0,14
86000US32438,"32438",3822,679,1870,384,1952,406,3487,695,1726,386,1761,408,74,87,40,48,34,39,261,164,104,81,157,127,0,14,0,14,0,14,0,14,0,14,0,14
86000US32439,"32439",10202,849,5234,499,4968,485,8936,818,4492,490,4444,452,746,417,479,274,267,150,257,207,115,87,142,131,243,107,137,80,106,49,20,30,11,17,9,14
86000US32440,"32440",7728,552,5030,426,2698,291,6002,488,3774,341,2228,274,560,246,367,189,193,88,968,199,790,162,178,85,181,105,90,67,91,55,17,22,9,15,8,16
86000US32442,"32442",3296,555,1608,298,1688,296,2977,558,1461,302,1516,292,198,143,96,84,102,90,72,45,48,40,24,20,49,69,3,6,46,69,0,14,0,14,0,14
86000US32443,"32443",3123,418,1423,232,1700,275,2911,434,1352,231,1559,283,178,122,68,55,110,79,27,34,0,14,27,34,7,13,3,5,4,8,0,14,0,14,0,14
86000US32444,"32444",21965,938,10258,687,11707,553,18012,958,8650,681,9362,615,2629,755,1028,299,1601,508,389,241,120,109,269,163,920,446,445,225,475,249,15,23,15,23,0,25
86000US32445,"32445",2484,284,1855,230,629,114,1855,247,1287,189,568,108,102,74,60,37,42,47,509,149,502,149,7,11,18,19,6,13,12,14,0,14,0,14,0,14
86000US32446,"32446",10966,740,5488,456,5478,419,9083,672,4627,411,4456,410,901,349,351,171,550,214,707,369,351,174,356,211,249,118,152,89,97,62,26,29,7,11,19,21
86000US32447,"32447",159,83,153,86,6,11,19,29,19,29,0,14,60,57,60,57,0,14,80,67,74,66,6,11,0,14,0,14,0,14,0,14,0,14,0,14
86000US32448,"32448",8298,690,4096,503,4202,337,7013,702,3585,467,3428,354,925,397,361,208,564,244,181,101,124,80,57,54,95,97,26,38,69,73,84,114,0,19,84,114
86000US32449,"32449",552,205,306,151,246,118,552,205,306,151,246,118,0,14,0,14,0,14,0,14,0,14,0,14,0,14,0,14,0,14,0,14,0,14,0,14
86000US32455,"32455",4054,498,2049,290,2005,290,3670,472,1866,278,1804,275,182,155,81,69,101,94,136,109,88,61,48,52,66,57,14,18,52,54,0,14,0,14,0,14
86000US32456,"32456",7984,368,4106,279,3878,235,6355,412,3309,295,3046,223,628,268,256,98,372,213,512,259,303,127,209,152,441,138,190,77,251,86,48,64,48,64,0,19
86000US32459,"32459",17144,1054,8242,673,8902,576,13457,1027,6337,618,7120,605,2007,910,1216,567,791,381,824,389,341,177,483,250,856,300,348,166,508,214,0,21,0,21,0,21
86000US32460,"32460",5561,414,3657,265,1904,252,4128,358,2393,230,1735,228,173,106,115,61,58,54,1184,198,1134,175,50,53,76,83,15,17,61,76,0,19,0,19,0,19
86000US32461,"32461",36,40,25,27,11,17,14,21,14,21,0,14,22,33,11,17,11,17,0,14,0,14,0,14,0,14,0,14,0,14,0,14,0,14,0,14
86000US32462,"32462",3447,412,1704,273,1743,215,3222,387,1614,268,1608,201,76,51,23,20,53,40,136,78,67,41,69,46,13,21,0,14,13,21,0,14,0,14,0,14
86000US32463,"32463",216,99,89,54,127,52,207,99,89,54,118,52,6,10,0,14,6,10,0,14,0,14,0,14,3,6,0,14,3,6,0,14,0,14,0,14
86000US32464,"32464",4276,483,2133,266,2143,303,3809,447,1949,261,1860,271,195,138,74,58,121,88,152,127,51,53,101,88,120,113,59,57,61,67,0,14,0,14,0,14
86000US32465,"32465",7949,359,5230,259,2719,224,5932,401,3670,296,2262,237,472,208,155,76,317,170,1487,276,1347,218,140,105,58,56,58,56,0,19,0,19,0,19,0,19
86000US32466,"32466",5717,1109,2787,558,2930,618,4900,901,2364,463,2536,516,494,356,239,218,255,163,148,173,113,136,35,59,163,162,59,74,104,134,12,19,12,19,0,19
86000US32501,"32501",11004,775,5726,527,5278,462,8502,705,4338,496,4164,401,1422,299,815,167,607,221,622,232,275,126,347,163,405,118,281,104,124,47,53,58,17,23,36,41
86000US32502,"32502",3324,463,1843,289,1481,259,2696,451,1415,268,1281,252,335,129,228,94,107,57,178,150,122,113,56,68,115,83,78,63,37,33,0,14,0,14,0,14
86000US32503,"32503",33798,1269,16049,967,17749,801,27858,1295,13258,823,14600,836,3093,664,1638,439,1455,325,709,272,262,112,447,229,1969,375,842,191,1127,261,169,107,49,45,120,83
86000US32504,"32504",22368,1261,10550,863,11818,752,17699,1199,8370,713,9329,769,2942,689,1370,373,1572,434,738,459,407,281,331,203,989,428,403,221,586,301,0,25,0,25,0,25
86000US32505,"32505",26066,1579,12229,959,13837,956,22711,1600,10450,1017,12261,915,2295,624,1295,390,1000,317,417,169,230,134,187,103,526,201,193,96,333,133,117,123,61,71,56,59
86000US32506,"32506",36126,1682,17831,1019,18295,943,29700,1497,14434,870,15266,838,2766,717,1345,395,1421,430,899,394,482,201,417,245,2559,616,1483,380,1076,286,202,143,87,80,115,88
86000US32507,"32507",30714,1551,15472,991,15242,869,23761,1359,11598,866,12163,813,2968,767,1459,408,1509,466,887,345,432,199,455,182,3065,748,1975,427,1090,500,33,38,8,16,25,30
86000US32508,"32508",5366,807,4240,802,1126,184,1958,367,1512,330,446,114,83,54,61,45,22,25,248,148,181,137,67,52,2993,600,2418,590,575,137,84,79,68,76,16,22
86000US32509,"32509",675,176,675,176,0,14,410,121,410,121,0,14,51,27,51,27,0,14,114,57,114,57,0,14,62,65,62,65,0,14,38,44,38,44,0,14
86000US32511,"32511",1034,303,785,263,249,149,239,87,189,74,50,48,0,14,0,14,0,14,60,50,52,47,8,15,735,214,544,183,191,109,0,14,0,14,0,14
86000US32514,"32514",41888,1597,19549,1007,22339,1182,31918,1617,15108,877,16810,1074,5516,1193,2314,580,3202,835,1672,419,739,209,933,299,2453,575,1220,313,1233,336,329,264,168,177,161,111
86000US32526,"32526",37115,1248,18128,821,18987,807,32400,1155,15889,707,16511,773,2808,786,1270,478,1538,408,674,244,313,132,361,145,1054,358,568,246,486,173,179,117,88,60,91,76
86000US32530,"32530",40,67,23,38,17,30,40,67,23,38,17,30,0,14,0,14,0,14,0,14,0,14,0,14,0,14,0,14,0,14,0,14,0,14,0,14
86000US32531,"32531",5526,796,2787,459,2739,433,4977,687,2543,424,2434,353,348,289,141,100,207,215,139,171,79,93,60,79,62,77,24,35,38,48,0,19,0,19,0,19
86000US32533,"32533",29329,1271,14393,826,14936,808,26623,1239,13144,794,13479,797,1900,594,868,243,1032,401,294,210,124,102,170,164,454,191,242,106,212,113,58,74,15,24,43,52
86000US32534,"32534",14624,1120,6789,606,7835,807,12731,906,5680,522,7051,712,1252,524,731,333,521,257,159,93,57,51,102,78,260,210,147,105,113,118,222,257,174,198,48,66
86000US32535,"32535",6038,548,3735,343,2303,301,4835,510,2736,294,2099,303,374,256,226,171,148,97,760,149,722,141,38,28,68,47,50,33,18,18,1,2,1,2,0,19
86000US32536,"32536",23638,1209,11791,762,11847,700,17728,1435,8820,830,8908,819,2394,747,1153,432,1241,415,928,502,467,283,461,252,2390,575,1241,331,1149,283,198,163,110,95,88,78
86000US32539,"32539",29607,1491,15908,997,13699,756,22656,1508,11696,951,10960,753,3468,753,1977,427,1491,455,1458,307,1117,232,341,180,1999,817,1092,498,907,374,26,31,26,31,0,29
86000US32541,"32541",18898,472,9318,371,9580,411,15208,546,7470,375,7738,377,1541,353,790,222,751,200,541,209,242,114,299,129,1505,374,798,221,707,195,103,60,18,20,85,59
86000US32542,"32542",3087,496,2031,320,1056,218,1834,388,1097,235,737,196,154,109,105,74,49,41,101,104,64,68,37,39,938,231,714,192,224,88,60,63,51,62,9,12
86000US32544,"32544",1884,447,1162,273,722,220,1143,325,668,186,475,172,339,232,163,116,176,125,26,26,19,22,7,13,358,134,294,117,64,42,18,25,18,25,0,14
86000US32547,"32547",33926,1339,16782,853,17144,850,27189,1306,13417,800,13772,810,3656,677,1980,415,1676,396,1520,510,682,228,838,346,1407,373,634,216,773,248,154,84,69,65,85,60
86000US32548,"32548",21339,712,10575,501,10764,540,16779,847,8401,516,8378,557,2515,568,1139,275,1376,352,743,317,377,157,366,204,1102,326,580,174,522,191,200,193,78,76,122,122
86000US32550,"32550",7769,730,3860,486,3909,424,5965,700,2912,434,3053,427,597,309,305,205,292,150,409,289,234,189,175,120,781,291,409,154,372,160,17,26,0,19,17,26
86000US32561,"32561",9897,369,5030,386,4867,297,8350,618,4246,475,4104,362,526,220,281,136,245,124,543,377,290,213,253,179,444,203,200,109,244,125,34,52,13,20,21,32
86000US32563,"32563",25532,1112,12532,594,13000,667,21599,1102,10582,592,11017,633,1677,540,754,302,923,343,501,278,260,191,241,111,1584,420,846,261,738,222,171,125,90,76,81,58
86000US32564,"32564",2852,764,1570,436,1282,365,2691,750,1450,435,1241,353,78,93,63,79,15,25,0,14,0,14,0,14,81,136,55,92,26,44,2,3,2,3,0,14
86000US32565,"32565",4989,374,2422,248,2567,200,4562,349,2218,231,2344,189,184,131,63,41,121,95,128,66,65,37,63,46,99,73,68,58,31,30,16,26,8,13,8,13
86000US32566,"32566",39695,1378,19448,936,20247,859,31388,1671,15039,1038,16349,856,2639,611,1303,397,1336,299,1754,825,985,496,769,516,3604,962,2012,583,1592,464,310,236,109,99,201,148
86000US32567,"32567",3080,489,1508,298,1572,225,2714,461,1353,285,1361,207,184,135,77,61,107,78,55,35,20,21,35,24,127,118,58,48,69,81,0,14,0,14,0,14
86000US32568,"32568",2764,457,1427,265,1337,255,2642,446,1355,258,1287,248,122,135,72,77,50,66,0,14,0,14,0,14,0,14,0,14,0,14,0,14,0,14,0,14
86000US32569,"32569",12464,744,6702,614,5762,422,10656,696,5618,527,5038,426,883,266,567,211,316,106,241,130,76,49,165,102,507,258,292,158,215,132,177,171,149,164,28,44
86000US32570,"32570",31099,1167,15094,744,16005,728,25029,1368,11948,766,13081,808,2987,714,1516,384,1471,431,1642,491,1024,332,618,211,1117,353,509,185,608,257,324,254,97,80,227,220
86000US32571,"32571",34887,1267,17590,838,17297,833,29292,1286,14395,779,14897,846,2132,643,1182,411,950,311,1222,515,736,342,486,237,2101,766,1200,485,901,378,140,113,77,70,63,63
86000US32577,"32577",4360,629,2118,333,2242,408,3906,591,1855,285,2051,401,363,292,241,213,122,93,44,66,9,14,35,53,47,51,13,20,34,39,0,14,0,14,0,14
86000US32578,"32578",32654,847,15958,646,16696,577,25966,920,12702,630,13264,591,2892,704,1361,360,1531,409,465,206,294,142,171,93,2720,648,1286,349,1434,397,611,248,315,150,296,123
86000US32579,"32579",10246,578,4779,349,5467,345,8550,511,4022,317,4528,308,1124,399,483,180,641,255,202,100,64,55,138,72,281,107,156,70,125,57,89,57,54,38,35,28
86000US32580,"32580",4450,321,2153,269,2297,210,3427,522,1613,272,1814,299,402,350,219,157,183,199,163,135,67,80,96,99,458,340,254,210,204,170,0,14,0,14,0,14
86000US32583,"32583",29206,1076,17599,795,11607,644,22940,1212,13097,707,9843,760,1844,494,1096,325,748,262,3052,487,2594,385,458,228,1333,493,796,339,537,245,37,41,16,22,21,33
86000US32601,"32601",19205,1339,9299,918,9906,942,12203,1086,6236,783,5967,684,4426,800,1847,473,2579,595,1662,423,678,309,984,329,433,160,202,98,231,99,481,258,336,237,145,79
86000US32603,"32603",6941,781,4009,588,2932,415,2835,484,1678,356,1157,269,1189,287,571,188,618,189,2393,429,1483,336,910,205,331,97,164,71,167,60,193,99,113,91,80,41
86000US32605,"32605",25280,1332,12046,807,13234,807,22000,1268,10629,784,11371,748,2141,506,817,229,1324,360,709,260,331,164,378,192,383,162,222,115,161,74,47,64,47,64,0,25
86000US32606,"32606",23316,1418,11053,946,12263,818,18857,1450,8783,879,10074,855,2449,665,1211,398,1238,365,1052,442,541,226,511,249,668,368,374,206,294,179,290,208,144,102,146,115
86000US32607,"32607",29971,1669,13735,1020,16236,1199,22392,1467,10123,935,12269,1017,4922,963,2331,508,2591,584,1490,358,763,243,727,254,766,191,345,129,421,143,401,190,173,91,228,143
86000US32608,"32608",49296,1993,24170,1265,25126,1375,36562,1744,18163,1189,18399,1063,6893,1067,3044,507,3849,708,2911,530,1631,369,1280,294,1992,491,819,260,1173,309,938,305,513,204,425,179
86000US32609,"32609",19929,1405,9759,945,10170,1025,16310,1239,7734,809,8576,967,2239,590,1222,293,1017,358,1013,363,647,265,366,156,290,139,102,67,188,95,77,74,54,61,23,27
86000US32612,"32612",7164,671,2965,389,4199,461,1024,165,424,145,600,146,1181,238,498,141,683,188,4209,464,1754,283,2455,329,672,172,259,99,413,138,78,54,30,33,48,38
86000US32615,"32615",13419,776,6181,505,7238,651,12117,914,5630,541,6487,679,650,322,348,188,302,191,436,286,66,57,370,244,91,70,31,30,60,59,125,159,106,150,19,35
86000US32616,"32616",1216,432,596,198,620,311,1199,435,580,202,619,311,4,5,3,5,1,2,13,21,13,21,0,14,0,14,0,14,0,14,0,14,0,14,0,14
86000US32617,"32617",4513,639,2092,323,2421,437,4212,613,1961,313,2251,428,156,125,64,62,92,72,114,104,53,48,61,59,31,45,14,23,17,24,0,14,0,14,0,14
86000US32618,"32618",8173,1365,3651,586,4522,912,7427,1345,3392,573,4035,885,227,213,121,87,106,156,469,362,123,126,346,263,50,55,15,19,35,44,0,19,0,19,0,19
86000US32619,"32619",5586,626,2713,340,2873,370,5248,637,2590,336,2658,383,212,142,69,57,143,99,107,85,40,38,67,54,5,8,0,19,5,8,14,23,14,23,0,19
86000US32621,"32621",4890,670,2461,391,2429,366,4194,706,2072,384,2122,387,354,210,148,101,206,171,260,131,191,108,69,62,78,95,46,55,32,45,4,9,4,9,0,14
86000US32622,"32622",1031,326,539,179,492,168,973,314,487,166,486,166,50,37,48,37,2,6,6,7,2,3,4,7,0,14,0,14,0,14,2,4,2,4,0,14
86000US32625,"32625",1672,244,861,160,811,137,1435,226,735,139,700,133,124,101,64,71,60,48,40,43,15,21,25,26,70,65,47,45,23,25,3,5,0,14,3,5
86000US32626,"32626",8697,736,3997,441,4700,449,7672,710,3498,412,4174,453,467,225,202,120,265,135,433,230,241,148,192,113,119,111,56,60,63,55,6,9,0,19,6,9
86000US32628,"32628",5338,442,3483,286,1855,278,4081,508,2633,320,1448,287,401,206,243,176,158,93,719,194,573,132,146,133,137,125,34,29,103,99,0,19,0,19,0,19
86000US32631,"32631",155,98,45,33,110,80,133,86,36,29,97,73,22,39,9,17,13,23,0,14,0,14,0,14,0,14,0,14,0,14,0,14,0,14,0,14
86000US32639,"32639",194,123,101,77,93,62,194,123,101,77,93,62,0,14,0,14,0,14,0,14,0,14,0,14,0,14,0,14,0,14,0,14,0,14,0,14
86000US32640,"32640",11109,1205,5717,671,5392,679,10403,1118,5330,632,5073,629,207,196,111,101,96,98,401,250,211,150,190,113,88,96,55,64,33,55,10,17,10,17,0,21
86000US32641,"32641",14803,1091,7247,639,7556,667,12764,999,6108,583,6656,599,1163,409,497,184,666,280,543,229,496,213,47,41,255,190,140,106,115,96,78,78,6,10,72,75
86000US32643,"32643",11579,859,5927,553,5652,496,10177,910,5179,528,4998,533,728,322,465,222,263,116,536,298,237,148,299,192,138,144,46,46,92,105,0,21,0,21,0,21
86000US32648,"32648",388,207,171,77,217,149,364,208,156,76,208,151,3,5,3,5,0,14,0,14,0,14,0,14,21,26,12,15,9,12,0,14,0,14,0,14
86000US32653,"32653",13901,1014,6833,655,7068,618,12132,1058,5978,647,6154,623,1110,490,509,205,601,365,396,200,205,120,191,130,205,122,83,51,122,91,58,90,58,90,0,21
86000US32656,"32656",15040,1038,7549,599,7491,646,12802,977,6465,554,6337,644,887,396,433,261,454,178,940,421,505,239,435,211,398,210,146,77,252,171,13,20,0,21,13,20
86000US32658,"32658",375,148,214,104,161,78,375,148,214,104,161,78,0,14,0,14,0,14,0,14,0,14,0,14,0,14,0,14,0,14,0,14,0,14,0,14
86000US32664,"32664",391,126,199,73,192,67,391,126,199,73,192,67,0,14,0,14,0,14,0,14,0,14,0,14,0,14,0,14,0,14,0,14,0,14,0,14
86000US32666,"32666",6579,948,3298,493,3281,580,5944,882,3011,458,2933,540,247,201,141,107,106,102,267,192,91,72,176,131,113,90,55,52,58,52,8,12,0,19,8,12
86000US32667,"32667",4339,596,2292,388,2047,296,3848,549,2023,361,1825,284,139,89,92,65,47,30,231,116,78,48,153,94,105,78,83,72,22,22,16,25,16,25,0,14
86000US32668,"32668",4642,715,2289,405,2353,382,4277,703,2098,411,2179,367,67,66,53,53,14,22,292,179,138,92,154,96,6,16,0,14,6,16,0,14,0,14,0,14
86000US32669,"32669",13866,1006,6980,654,6886,651,12155,1091,6201,676,5954,652,1311,364,604,197,707,221,232,146,85,88,147,89,128,106,84,78,44,38,40,37,6,13,34,34
86000US32680,"32680",10050,509,5208,337,4842,281,9044,639,4727,387,4317,357,381,227,214,138,167,120,500,255,214,119,286,153,124,124,52,72,72,69,1,2,1,2,0,21
86000US32681,"32681",31,47,16,24,15,23,31,47,16,24,15,23,0,14,0,14,0,14,0,14,0,14,0,14,0,14,0,14,0,14,0,14,0,14,0,14
86000US32683,"32683",268,170,134,111,134,88,179,200,110,127,69,75,0,14,0,14,0,14,0,14,0,14,0,14,89,139,24,38,65,102,0,14,0,14,0,14
86000US32686,"32686",4725,665,2501,477,2224,327,4496,652,2413,471,2083,324,135,95,60,48,75,61,85,58,24,21,61,49,8,12,4,6,4,6,1,2,0,14,1,2
86000US32692,"32692",160,164,96,111,64,60,160,164,96,111,64,60,0,14,0,14,0,14,0,14,0,14,0,14,0,14,0,14,0,14,0,14,0,14,0,14
86000US32693,"32693",11837,842,6568,522,5269,504,9172,732,4810,446,4362,409,853,288,557,217,296,133,1554,292,1063,215,491,160,254,140,136,87,118,77,4,12,2,6,2,6
86000US32694,"32694",2003,441,984,260,1019,264,1885,468,947,262,938,284,47,36,18,19,29,26,48,59,6,10,42,50,23,25,13,15,10,11,0,14,0,14,0,14
86000US32696,"32696",12322,1004,5854,501,6468,587,10839,829,5029,422,5810,568,456,230,230,148,226,102,805,440,459,344,346,149,179,95,112,66,67,46,43,46,24,23,19,25
86000US32697,"32697",248,98,111,49,137,66,194,85,88,44,106,55,18,22,9,12,9,12,15,19,4,6,11,14,21,33,10,16,11,19,0,14,0,14,0,14
86000US32701,"32701",22768,1057,11272,794,11496,598,18838,1069,9195,775,9643,536,1634,441,866,260,768,247,1541,313,915,228,626,155,606,305,256,154,350,185,149,112,40,55,109,96
86000US32702,"32702",2787,413,1353,235,1434,243,2397,386,1127,200,1270,238,256,126,147,94,109,69,83,45,36,31,47,30,44,51,36,47,8,11,7,14,7,14,0,14
86000US32703,"32703",53145,2412,25566,1500,27579,1462,45997,2174,22341,1397,23656,1289,4385,1024,2060,469,2325,636,1902,636,754,253,1148,496,574,275,228,127,346,171,287,143,183,115,104,63
86000US32707,"32707",35712,1144,16656,724,19056,790,31672,1318,14803,714,16869,839,1658,434,736,251,922,242,1691,379,755,192,936,264,614,243,314,151,300,124,77,72,48,39,29,42
86000US32708,"32708",44984,905,22061,851,22923,717,38101,1353,18652,952,19449,850,2723,607,1340,350,1383,345,2528,764,1284,409,1244,481,1075,371,496,228,579,207,557,370,289,232,268,173
86000US32709,"32709",1832,429,868,223,964,261,1652,412,771,204,881,259,54,62,18,26,36,40,24,42,12,21,12,20,102,161,67,106,35,56,0,14,0,14,0,14
86000US32712,"32712",47708,2037,24393,1376,23315,1319,43099,2000,22105,1301,20994,1325,2105,599,1071,347,1034,301,1359,414,669,221,690,228,1048,357,524,211,524,191,97,77,24,39,73,60
86000US32713,"32713",20725,150,10582,427,10143,445,18146,512,9143,511,9003,433,1055,403,532,228,523,267,938,374,541,228,397,176,574,307,354,223,220,103,12,20,12,20,0,25
86000US32714,"32714",37652,1279,17788,843,19864,852,31384,1592,14968,961,16416,958,3131,681,1485,400,1646,413,1742,525,787,306,955,293,958,384,400,196,558,239,437,244,148,118,289,153
86000US32720,"32720",32115,1518,15188,1028,16927,903,27711,1703,12742,1028,14969,963,2182,474,1308,305,874,276,1477,439,686,235,791,276,707,236,425,186,282,146,38,47,27,42,11,23
86000US32724,"32724",36528,1284,17514,869,19014,814,30825,1258,14817,844,16008,733,3524,700,1609,366,1915,423,1165,423,685,258,480,194,716,235,267,140,449,148,298,194,136,116,162,85
86000US32725,"32725",49282,1375,23931,974,25351,1023,44574,1402,21656,947,22918,988,2161,604,1070,364,1091,316,1511,421,638,233,873,326,730,292,385,199,345,171,306,172,182,111,124,77
86000US32726,"32726",22190,636,10353,540,11837,527,18990,733,8825,555,10165,599,1918,540,855,271,1063,305,752,332,389,189,363,223,489,223,275,133,214,128,41,39,9,12,32,37
86000US32730,"32730",5879,799,3304,587,2575,416,4445,711,2461,512,1984,372,497,332,286,199,211,197,578,383,300,258,278,175,338,213,236,153,102,84,21,34,21,34,0,19
86000US32732,"32732",4533,612,2512,384,2021,362,4207,603,2364,384,1843,355,299,209,121,94,178,124,13,21,13,21,0,14,14,22,14,22,0,14,0,14,0,14,0,14
86000US32735,"32735",4662,627,2363,421,2299,321,4033,657,1942,399,2091,343,236,246,152,166,84,84,367,307,256,226,111,89,26,38,13,19,13,19,0,14,0,14,0,14
86000US32736,"32736",10652,932,5370,526,5282,545,9229,977,4669,518,4560,570,600,299,285,160,315,162,296,152,106,70,190,93,241,172,139,115,102,75,286,441,171,260,115,182
86000US32738,"32738",45041,1191,22213,998,22828,941,41071,1288,20286,964,20785,1007,1649,410,902,293,747,220,1334,451,531,246,803,285,543,199,310,113,233,106,444,330,184,151,260,210
86000US32744,"32744",3781,455,1835,229,1946,275,3270,455,1593,227,1677,271,300,158,157,90,143,79,112,100,56,49,56,52,99,83,29,39,70,60,0,14,0,14,0,14
86000US32746,"32746",44797,1195,21356,826,23441,800,36199,1606,16794,899,19405,981,3645,794,1907,428,1738,486,2198,676,1180,344,1018,409,2294,710,1204,414,1090,361,461,175,271,126,190,91
86000US32750,"32750",24806,771,11957,547,12849,499,21674,823,10394,514,11280,544,1440,464,812,289,628,201,1162,330,579,216,583,186,441,228,130,91,311,157,89,67,42,35,47,55
86000US32751,"32751",22301,1173,10756,662,11545,689,19389,1308,9465,716,9924,723,1584,369,735,195,849,228,805,254,382,168,423,142,426,213,139,83,287,158,97,72,35,35,62,44
86000US32754,"32754",10926,864,5697,506,5229,502,10178,837,5388,505,4790,478,282,173,130,77,152,122,93,67,37,40,56,50,373,201,142,85,231,120,0,21,0,21,0,21
86000US32757,"32757",27497,1509,12689,954,14808,917,24629,1465,11194,864,13435,948,1155,415,551,259,604,207,890,326,519,221,371,172,745,396,399,272,346,150,78,88,26,28,52,62
86000US32759,"32759",3014,564,1565,368,1449,261,2812,535,1471,348,1341,251,111,122,59,68,52,56,51,50,22,24,29,27,40,44,13,14,27,42,0,14,0,14,0,14
86000US32763,"32763",23088,1058,11422,774,11666,583,19288,1302,9601,857,9687,677,1889,546,913,275,976,334,1391,505,664,287,727,264,406,185,181,89,225,121,114,112,63,64,51,55
86000US32764,"32764",3161,352,1691,232,1470,195,2644,303,1404,217,1240,171,347,254,217,145,130,114,128,77,50,37,78,48,42,32,20,20,22,18,0,14,0,14,0,14
86000US32765,"32765",63644,1498,30651,1027,32993,1002,54499,1542,25807,956,28692,990,3016,679,1624,415,1392,335,3866,640,2255,448,1611,358,1891,553,810,265,1081,365,372,179,155,90,217,118
86000US32766,"32766",16713,772,8304,564,8409,491,14812,956,7354,592,7458,575,514,279,247,177,267,168,300,194,122,80,178,150,942,501,501,262,441,260,145,204,80,106,65,99
86000US32767,"32767",3334,703,1830,448,1504,359,2613,588,1372,348,1241,310,462,328,301,219,161,122,174,111,72,66,102,85,84,132,84,132,0,14,1,2,1,2,0,14
86000US32771,"32771",55971,1940,27007,1177,28964,1419,46421,2344,21954,1352,24467,1425,4018,952,2184,691,1834,423,2578,643,1296,473,1282,320,2038,795,945,344,1093,492,916,359,628,263,288,143
86000US32773,"32773",30924,1273,15348,825,15576,851,25814,1312,12764,789,13050,846,2351,759,1216,455,1135,397,1679,517,883,344,796,284,829,383,387,202,442,198,251,164,98,91,153,105
86000US32776,"32776",11762,1404,5591,820,6171,856,9992,1322,4566,758,5426,845,289,218,191,151,98,103,871,506,485,250,386,286,610,503,349,270,261,276,0,21,0,21,0,21
86000US32778,"32778",22440,668,10371,583,12069,541,17904,892,7999,637,9905,585,2580,662,1361,365,1219,358,1002,319,507,164,495,199,813,278,471,165,342,134,141,87,33,27,108,72
86000US32779,"32779",29522,902,14018,502,15504,692,25922,1056,12208,560,13714,740,1516,368,750,194,766,204,1090,376,559,200,531,217,559,190,257,103,302,110,435,220,244,145,191,122
86000US32780,"32780",35793,1047,16522,717,19271,956,30163,1365,13563,718,16600,1135,3234,717,1559,379,1675,398,1012,343,586,225,426,205,1173,411,727,303,446,170,211,138,87,64,124,124
86000US32784,"32784",12146,1093,6030,663,6116,631,10550,1108,5273,642,5277,641,883,444,331,256,552,283,393,273,217,173,176,111,319,183,208,135,111,84,1,2,1,2,0,21
86000US32789,"32789",26345,829,12434,510,13911,653,21958,847,10452,468,11506,634,2252,406,1005,220,1247,257,1253,288,592,157,661,178,758,210,331,110,427,143,124,85,54,49,70,45
86000US32792,"32792",51141,1681,25640,1050,25501,1173,38787,1755,19282,1114,19505,1092,4901,872,2335,506,2566,527,4354,820,2389,484,1965,457,2058,509,1162,312,896,299,1041,383,472,186,569,269
86000US32796,"32796",20382,1068,9953,594,10429,761,17408,1143,8678,588,8730,720,1557,562,572,243,985,416,647,273,334,144,313,157,709,335,344,184,365,168,61,76,25,34,36,45
86000US32798,"32798",2882,560,1566,377,1316,260,2635,585,1414,378,1221,268,199,157,138,122,61,60,34,64,0,14,34,64,14,23,14,23,0,14,0,14,0,14,0,14
86000US32801,"32801",12233,1032,6352,727,5881,628,8821,837,4565,545,4256,565,1842,413,999,354,843,215,960,270,493,173,467,194,351,145,137,70,214,113,259,174,158,124,101,85
86000US32803,"32803",19983,1222,10299,923,9684,679,16752,1181,8884,863,7868,643,1776,386,775,184,1001,299,908,247,415,137,493,188,444,142,175,85,269,110,103,79,50,46,53,44
86000US32804,"32804",17921,991,8801,580,9120,671,14653,879,7284,537,7369,596,1878,523,853,243,1025,330,919,262,499,178,420,168,336,138,145,100,191,81,135,118,20,22,115,104
86000US32805,"32805",18706,1248,9035,789,9671,836,16371,1171,7799,766,8572,789,1230,348,624,194,606,217,703,358,389,234,314,147,255,144,161,111,94,72,147,138,62,78,85,73
86000US32806,"32806",27299,1352,13724,863,13575,875,23039,1367,11627,834,11412,838,2693,431,1261,270,1432,292,852,300,435,149,417,201,608,343,294,174,314,185,107,98,107,98,0,25
86000US32807,"32807",34205,1765,17324,1119,16881,1068,29642,1612,14889,1037,14753,934,2746,565,1424,388,1322,312,929,288,518,161,411,176,478,175,295,107,183,90,410,234,198,131,212,139
86000US32808,"32808",58666,1982,27830,1441,30836,1312,45145,2008,21539,1248,23606,1398,8660,1596,4005,855,4655,939,1945,616,1015,417,930,343,1519,585,560,253,959,448,1397,648,711,387,686,348
86000US32809,"32809",28718,1459,15148,931,13570,953,24623,1452,13107,1000,11516,880,2420,644,1217,351,1203,389,992,352,440,165,552,235,343,303,178,159,165,152,340,121,206,102,134,86
86000US32810,"32810",37547,1957,18019,1100,19528,1400,30312,1788,14568,990,15744,1271,3246,765,1469,428,1777,535,1865,623,1078,427,787,267,1583,738,773,337,810,482,541,235,131,107,410,196
86000US32811,"32811",40301,2129,18980,1353,21321,1294,30137,2090,13933,1236,16204,1236,5960,995,2919,601,3041,569,1420,516,712,337,708,257,1135,377,684,240,451,201,1649,469,732,275,917,275
86000US32812,"32812",35481,1374,16949,888,18532,1032,30499,1290,14786,933,15713,754,3250,724,1446,383,1804,457,1028,549,374,238,654,369,336,252,132,118,204,143,368,323,211,179,157,148
86000US32814,"32814",8021,1165,3746,612,4275,729,6151,1137,3043,591,3108,680,963,631,323,207,640,455,375,344,217,205,158,156,443,261,133,88,310,223,89,124,30,49,59,80
86000US32817,"32817",35323,1389,18167,1008,17156,899,28191,1478,14841,1008,13350,883,3625,585,1757,386,1868,345,2093,363,956,237,1137,263,983,293,466,143,517,187,431,301,147,94,284,222
86000US32818,"32818",57259,2140,26780,1318,30479,1527,47905,2039,22232,1296,25673,1332,6746,1071,3336,635,3410,638,1326,508,627,265,699,335,772,357,407,243,365,168,510,391,178,118,332,309
86000US32819,"32819",27518,1153,13495,688,14023,829,21846,1283,10698,680,11148,877,3028,702,1410,358,1618,404,1476,508,787,347,689,193,800,342,513,270,287,122,368,216,87,57,281,185
86000US32820,"32820",10192,1010,5310,698,4882,492,9094,981,4765,640,4329,524,819,451,394,230,425,243,150,105,105,83,45,61,129,92,46,41,83,64,0,21,0,21,0,21
86000US32821,"32821",17207,1449,7732,745,9475,998,11932,1282,5329,623,6603,911,2667,577,1210,290,1457,420,891,298,323,151,568,226,1177,356,556,203,621,209,540,229,314,144,226,132
86000US32822,"32822",60933,2738,29808,1528,31125,1752,49539,2337,24232,1335,25307,1556,5221,1127,2545,637,2676,599,1704,537,1025,331,679,259,1894,685,747,262,1147,539,2575,633,1259,330,1316,380
86000US32824,"32824",46292,2869,22869,1829,23423,1672,39405,3106,19743,1890,19662,1825,3827,1041,1767,485,2060,624,935,479,559,304,376,227,1198,649,491,255,707,501,927,492,309,210,618,365
86000US32825,"32825",60673,2386,28832,1512,31841,1435,50966,2134,24394,1407,26572,1363,5682,1059,2543,542,3139,652,1808,546,770,239,1038,349,872,430,432,208,440,246,1345,834,693,476,652,390
86000US32826,"32826",35899,2109,18280,1176,17619,1411,24621,1662,12504,905,12117,1153,3331,937,1893,545,1438,549,6625,834,3391,546,3234,410,1116,483,384,217,732,374,206,89,108,67,98,63
86000US32827,"32827",9352,813,4352,467,5000,560,7244,718,3456,420,3788,514,907,361,258,116,649,273,456,221,240,122,216,121,613,294,339,142,274,170,132,105,59,50,73,63
86000US32828,"32828",68934,2776,32764,1923,36170,1969,56070,2816,26520,1828,29550,1836,6657,1698,3404,998,3253,972,2425,1069,978,586,1447,577,2318,870,1173,511,1145,436,1464,718,689,408,775,409
86000US32829,"32829",19927,1772,9373,1000,10554,1021,17092,1692,7965,940,9127,991,1468,571,725,289,743,326,796,409,489,284,307,154,234,235,123,156,111,106,337,328,71,90,266,305
86000US32830,"32830",6,10,6,10,0,14,6,10,6,10,0,14,0,14,0,14,0,14,0,14,0,14,0,14,0,14,0,14,0,14,0,14,0,14,0,14
86000US32831,"32831",3228,444,3228,444,0,14,1695,265,1695,265,0,14,197,68,197,68,0,14,1275,405,1275,405,0,14,61,42,61,42,0,14,0,14,0,14,0,14
86000US32832,"32832",27584,1986,13803,1236,13781,1137,19439,2075,9724,1257,9715,1201,4105,1442,2023,702,2082,815,1665,641,880,514,785,379,1439,491,652,253,787,290,936,594,524,387,412,270
86000US32833,"32833",9789,898,4631,555,5158,685,8910,820,4143,418,4767,676,427,308,227,193,200,143,118,116,62,63,56,64,285,325,185,271,100,82,49,58,14,22,35,56
86000US32835,"32835",47394,2084,22849,1397,24545,1329,35710,2318,17544,1380,18166,1361,6683,1056,2940,558,3743,685,1453,512,775,319,678,279,2328,896,983,426,1345,573,1220,592,607,312,613,329
86000US32836,"32836",19823,1529,10228,936,9595,975,15682,1384,8357,856,7325,825,2412,677,1215,395,1197,404,368,225,42,70,326,199,1104,464,487,250,617,283,257,175,127,114,130,115
86000US32837,"32837",51000,2347,25300,1584,25700,1364,44028,2436,21776,1493,22252,1438,3720,1039,1797,636,1923,510,1314,511,851,437,463,172,736,280,273,118,463,222,1202,429,603,243,599,240
86000US32839,"32839",52045,2367,25523,1556,26522,1500,40562,2248,18770,1410,21792,1435,7239,1140,4269,565,2970,693,1412,403,886,268,526,210,1856,731,1077,480,779,330,976,380,521,247,455,197
86000US32901,"32901",24756,1016,12303,638,12453,704,19920,1043,9704,666,10216,708,2577,589,1086,314,1491,390,718,249,494,199,224,90,841,261,483,164,358,147,700,235,536,196,164,80
86000US32903,"32903",14355,715,6770,452,7585,461,11885,696,5611,410,6274,444,1810,575,798,276,1012,374,297,166,147,102,150,97,363,200,214,125,149,100,0,21,0,21,0,21
86000US32904,"32904",31505,1125,15456,829,16049,910,25819,1206,12559,719,13260,854,3199,978,1447,451,1752,673,626,280,340,168,286,151,1116,493,687,442,429,170,745,583,423,315,322,290
86000US32905,"32905",23104,1160,11850,812,11254,811,19016,1076,9940,804,9076,720,2050,613,880,302,1170,423,862,456,496,298,366,237,945,412,469,293,476,178,231,171,65,58,166,119
86000US32907,"32907",44663,1255,21211,935,23452,1067,39341,1464,18990,985,20351,1005,3094,830,1143,382,1951,540,778,318,409,179,369,188,1329,517,619,249,710,346,121,108,50,62,71,60
86000US32908,"32908",13299,1434,6559,883,6740,832,11203,1426,5518,813,5685,903,1266,971,625,497,641,504,334,391,156,197,178,204,492,375,256,207,236,190,4,10,4,10,0,21
86000US32909,"32909",30791,1226,14996,849,15795,1085,27438,1282,13387,919,14051,1039,2331,643,1161,438,1170,367,275,178,147,112,128,90,533,364,238,177,295,194,214,252,63,63,151,192
86000US32920,"32920",10214,121,5072,355,5142,376,8348,363,4147,359,4201,354,944,300,469,197,475,139,155,89,100,66,55,41,742,268,339,136,403,189,25,30,17,20,8,13
86000US32922,"32922",16443,1343,7745,767,8698,789,13733,1330,6402,681,7331,803,1644,481,810,315,834,289,485,258,221,144,264,184,556,326,287,165,269,174,25,41,25,41,0,21
86000US32925,"32925",1514,186,882,125,632,91,1032,190,571,131,461,85,185,150,116,97,69,57,35,29,16,17,19,15,240,99,166,77,74,43,22,16,13,11,9,9
86000US32926,"32926",21790,1635,11057,1180,10733,933,18324,1395,9051,879,9273,845,1907,580,1124,493,783,291,498,271,322,207,176,120,1004,513,530,268,474,294,57,55,30,40,27,35
86000US32927,"32927",27145,1284,13838,952,13307,921,24514,1195,12433,859,12081,846,1406,365,727,225,679,245,462,292,281,213,181,128,592,273,289,144,303,141,171,144,108,93,63,60
86000US32931,"32931",13759,329,6649,331,7110,332,11294,429,5475,327,5819,343,1097,258,462,138,635,169,229,97,110,54,119,63,953,311,498,154,455,203,186,113,104,65,82,58
86000US32934,"32934",18997,925,9270,563,9727,683,16241,716,7992,430,8249,536,1613,409,704,232,909,277,179,112,122,109,57,47,791,290,350,147,441,196,173,130,102,76,71,86
86000US32935,"32935",40774,1288,20025,955,20749,980,35166,1208,17200,948,17966,843,3112,539,1381,254,1731,397,686,226,361,131,325,141,1551,421,942,262,609,231,259,159,141,89,118,98
86000US32937,"32937",27334,758,13347,545,13987,560,23212,861,11270,531,11942,615,2171,501,1116,319,1055,246,518,322,246,171,272,165,1353,395,674,232,679,212,80,69,41,39,39,39
86000US32940,"32940",41797,1830,19460,1128,22337,1180,35904,1676,16814,1093,19090,1022,3465,927,1514,488,1951,555,1073,380,463,198,610,259,1241,465,604,293,637,233,114,138,65,92,49,57
86000US32948,"32948",7437,768,3742,581,3695,515,7199,754,3633,568,3566,507,172,206,64,80,108,138,43,62,22,51,21,38,0,19,0,19,0,19,23,52,23,52,0,19
86000US32949,"32949",2440,305,1109,178,1331,235,2124,319,953,168,1171,238,184,112,60,36,124,96,49,47,33,31,16,18,83,75,63,58,20,25,0,14,0,14,0,14
86000US32950,"32950",4514,302,2328,195,2186,241,4137,289,2121,195,2016,224,288,189,137,121,151,98,7,11,7,11,0,14,82,48,63,48,19,24,0,14,0,14,0,14
86000US32951,"32951",11851,617,6187,408,5664,348,10287,585,5353,383,4934,335,589,199,303,118,286,111,153,113,105,77,48,45,781,270,410,161,371,122,41,48,16,19,25,30
86000US32952,"32952",20696,841,10600,589,10096,541,18008,896,9367,602,8641,514,1311,456,615,235,696,277,573,255,297,141,276,141,742,317,278,129,464,210,62,70,43,55,19,30
86000US32953,"32953",23794,1180,11591,686,12203,744,19958,1142,9799,657,10159,722,2149,446,1011,228,1138,305,497,195,199,103,298,158,1053,306,520,166,533,196,137,88,62,45,75,61
86000US32955,"32955",38600,1296,18729,925,19871,866,34370,1372,16861,941,17509,823,2501,532,1085,299,1416,319,578,233,286,152,292,155,1041,349,441,198,600,224,110,85,56,63,54,47
86000US32958,"32958",28436,605,13786,621,14650,654,24933,808,12099,652,12834,613,1587,517,818,287,769,310,1230,417,562,219,668,282,538,218,264,121,274,149,148,109,43,47,105,101
86000US32960,"32960",21603,972,10205,786,11398,681,18024,942,8463,725,9561,670,1656,450,785,257,871,323,665,186,399,112,266,121,1000,326,512,216,488,162,258,213,46,61,212,181
86000US32962,"32962",26239,2126,13171,1255,13068,1344,23248,2058,11873,1265,11375,1267,1584,511,692,354,892,322,412,187,211,105,201,128,921,530,362,237,559,322,74,51,33,34,41,28
86000US32963,"32963",15022,841,7166,496,7856,515,13327,792,6333,473,6994,499,531,201,268,123,263,110,331,165,162,107,169,111,781,286,389,180,392,127,52,40,14,16,38,35
86000US32966,"32966",18428,1341,8242,748,10186,834,16247,1200,7217,668,9030,771,852,327,376,160,476,226,340,179,161,108,179,121,900,336,437,185,463,195,89,101,51,78,38,63
86000US32967,"32967",22177,1410,10566,894,11611,979,19740,1482,9259,824,10481,1009,853,392,543,318,310,147,866,433,448,241,418,270,650,386,297,170,353,233,68,87,19,44,49,75
86000US32968,"32968",13035,1070,6444,680,6591,579,10530,977,5207,571,5323,561,923,369,415,180,508,274,505,248,306,167,199,121,679,364,248,170,431,284,398,374,268,223,130,174
86000US32970,"32970",369,293,122,179,247,219,231,220,0,14,231,220,138,203,122,179,16,25,0,14,0,14,0,14,0,14,0,14,0,14,0,14,0,14,0,14
86000US32976,"32976",9092,690,4550,445,4542,427,7873,622,3951,404,3922,378,140,99,60,47,80,75,280,165,196,124,84,63,754,325,310,142,444,205,45,72,33,52,12,19
86000US33001,"33001",331,124,173,72,158,64,241,113,129,66,112,59,16,21,4,7,12,19,0,14,0,14,0,14,47,55,25,29,22,27,27,21,15,12,12,10
86000US33004,"33004",15666,824,7694,623,7972,618,12982,1021,6179,680,6803,665,1593,481,796,268,797,269,653,346,472,276,181,103,367,200,198,127,169,109,71,64,49,48,22,24
86000US33009,"33009",41239,449,19701,685,21538,724,33470,1210,15642,791,17828,846,3866,943,2081,639,1785,419,1945,532,973,339,972,286,886,319,490,169,396,177,1072,356,515,180,557,243
86000US33010,"33010",44802,1403,21880,990,22922,908,41795,1481,20296,961,21499,948,2185,474,1146,315,1039,270,221,115,127,84,94,52,40,43,4,6,36,42,561,267,307,173,254,144
86000US33012,"33012",73232,1875,33977,1300,39255,1356,67665,2005,31075,1279,36590,1376,3749,826,1952,526,1797,396,515,344,230,152,285,209,186,149,116,100,70,64,1117,371,604,261,513,211
86000US33013,"33013",31485,1382,15472,903,16013,805,29771,1333,14701,885,15070,756,1331,479,539,187,792,341,108,75,70,51,38,51,53,56,29,31,24,33,222,212,133,125,89,89
86000US33014,"33014",41527,1625,19541,1049,21986,1011,36961,1677,17381,1064,19580,1010,3483,820,1644,475,1839,463,190,99,43,45,147,85,130,97,97,74,33,34,763,397,376,229,387,213
86000US33015,"33015",66462,2082,31571,1350,34891,1416,56675,2314,26993,1328,29682,1527,7292,1272,3338,655,3954,726,1009,442,659,322,350,200,56,65,19,30,37,63,1430,524,562,290,868,305
86000US33016,"33016",50888,1726,23852,1193,27036,915,45501,1787,21272,1253,24229,866,3575,784,1630,363,1945,526,405,245,225,141,180,131,211,187,97,96,114,106,1196,458,628,269,568,244
86000US33018,"33018",52760,1827,25573,1077,27187,1309,48055,1914,23276,1163,24779,1287,3661,914,1830,487,1831,535,645,368,283,160,362,251,117,85,97,77,20,23,282,159,87,65,195,118
86000US33019,"33019",13552,815,6940,519,6612,477,11764,803,5895,498,5869,458,522,186,312,150,210,99,548,282,351,202,197,105,343,166,183,96,160,85,375,155,199,85,176,87
86000US33020,"33020",44518,1465,23121,929,21397,1056,35460,1673,18449,963,17011,1067,5494,973,2721,537,2773,593,1636,569,904,350,732,283,1038,290,600,206,438,172,890,388,447,223,443,222
86000US33021,"33021",49285,1559,23719,979,25566,1076,42576,1521,20522,971,22054,1059,3676,880,1732,467,1944,506,1424,510,850,363,574,206,1346,470,499,242,847,331,263,190,116,99,147,100
86000US33023,"33023",72954,1928,35083,1308,37871,1433,66034,2038,31462,1323,34572,1444,3541,697,1846,431,1695,362,2029,680,1010,388,1019,340,750,378,458,186,292,238,600,234,307,145,293,130
86000US33024,"33024",75610,2057,36180,1304,39430,1455,67050,1864,32162,1190,34888,1286,5374,1172,2373,637,3001,651,1233,444,672,329,561,230,971,449,452,240,519,268,982,356,521,214,461,220
86000US33025,"33025",72583,2598,34447,1601,38136,1696,63869,2598,30146,1657,33723,1666,3997,1004,2077,572,1920,537,2966,776,1341,379,1625,485,747,281,405,161,342,175,1004,370,478,224,526,190
86000US33026,"33026",31694,1084,14774,594,16920,892,28324,1123,13161,590,15163,892,2038,537,1007,337,1031,283,752,385,367,193,385,209,383,174,183,92,200,126,197,166,56,61,141,130
86000US33027,"33027",60048,2861,27725,1758,32323,1677,55529,2952,25620,1651,29909,1833,2317,1104,1046,636,1271,573,1053,413,541,260,512,253,209,107,147,89,62,55,940,546,371,185,569,400
86000US33028,"33028",26641,1198,13042,728,13599,745,23883,1120,11720,692,12163,674,1532,432,774,201,758,267,435,208,315,155,120,75,437,216,173,102,264,154,354,193,60,48,294,159
86000US33029,"33029",47885,2919,24465,1923,23420,1541,44490,3087,22747,1996,21743,1582,1854,692,1035,448,819,319,650,441,289,214,361,269,493,317,183,128,310,207,398,359,211,220,187,174
86000US33030,"33030",34531,1966,18500,1315,16031,1100,30969,1904,16525,1229,14444,1081,2640,771,1465,556,1175,370,229,200,96,95,133,138,228,186,113,95,115,161,465,247,301,200,164,122
86000US33031,"33031",7073,1165,3918,762,3155,595,6735,1106,3710,715,3025,603,92,70,58,51,34,40,65,61,41,49,24,37,42,66,42,66,0,19,139,190,67,91,72,99
86000US33032,"33032",49567,2528,24430,1524,25137,1444,41039,2680,20105,1532,20934,1505,6576,1225,3223,624,3353,715,463,317,282,234,181,136,710,344,366,204,344,191,779,389,454,299,325,194
86000US33033,"33033",57323,2440,28329,1272,28994,1510,49988,2464,24809,1287,25179,1522,5206,1129,2464,578,2742,670,340,225,166,103,174,132,744,284,388,173,356,148,1045,416,502,234,543,272
86000US33034,"33034",21765,1120,11213,854,10552,658,17706,1045,8922,690,8784,678,2763,871,1368,476,1395,491,1119,329,824,272,295,114,25,32,25,32,0,25,152,128,74,83,78,99
86000US33035,"33035",16029,1431,7396,890,8633,927,12894,1536,6100,891,6794,986,2606,1096,1083,475,1523,651,133,109,19,31,114,96,358,264,190,147,168,153,38,57,4,9,34,56
86000US33036,"33036",3470,332,1838,216,1632,182,3012,334,1594,198,1418,187,99,75,42,39,57,40,202,117,108,75,94,56,152,91,89,59,63,42,5,8,5,8,0,14
86000US33037,"33037",10775,657,5236,383,5539,410,9260,614,4489,368,4771,365,500,210,261,91,239,136,402,133,164,75,238,100,540,224,289,184,251,113,73,46,33,21,40,38
86000US33039,"33039",280,216,101,74,179,158,155,100,79,63,76,46,125,185,22,37,103,148,0,14,0,14,0,14,0,14,0,14,0,14,0,14,0,14,0,14
86000US33040,"33040",33997,636,18060,479,15937,468,26877,1205,14151,759,12726,654,3798,773,2143,456,1655,406,636,187,360,122,276,103,2137,452,1077,263,1060,252,549,356,329,212,220,157
86000US33042,"33042",6615,422,3463,253,3152,265,5319,437,2793,265,2526,222,735,321,320,136,415,196,233,128,196,113,37,30,313,113,154,62,159,69,15,24,0,19,15,24
86000US33043,"33043",4878,430,2501,267,2377,265,3911,418,2016,261,1895,248,298,190,123,81,175,130,231,107,148,75,83,45,266,102,139,60,127,65,172,201,75,112,97,101
86000US33050,"33050",9300,217,5030,251,4270,290,7455,428,3998,289,3457,299,971,347,527,199,444,194,420,208,289,152,131,77,312,126,145,70,167,79,142,83,71,64,71,53
86000US33051,"33051",534,123,278,73,256,67,413,99,213,62,200,54,39,40,22,25,17,21,0,14,0,14,0,14,82,63,43,34,39,30,0,14,0,14,0,14
86000US33054,"33054",31456,1355,15369,904,16087,987,27746,1545,13577,932,14169,1105,2989,869,1355,407,1634,528,442,302,323,193,119,133,135,101,59,52,76,57,144,109,55,80,89,86
86000US33055,"33055",40424,1888,19078,1104,21346,1357,36903,1951,17154,1235,19749,1238,2787,819,1669,492,1118,416,183,110,104,76,79,69,93,82,37,37,56,55,458,224,114,91,344,185
86000US33056,"33056",35770,1411,15886,890,19884,1054,32936,1547,14770,919,18166,1053,1749,506,657,218,1092,354,812,458,368,201,444,271,141,116,35,34,106,105,132,94,56,52,76,67
86000US33060,"33060",37138,1463,19217,1163,17921,782,31050,1586,15964,1175,15086,739,4396,971,2333,518,2063,547,547,177,374,157,173,78,782,369,406,227,376,173,363,303,140,160,223,211
86000US33062,"33062",22561,942,11467,662,11094,577,19225,945,9683,643,9542,546,1753,369,1003,257,750,185,347,159,136,74,211,104,837,225,415,129,422,133,399,161,230,112,169,71
86000US33063,"33063",54233,1396,25068,984,29165,1157,46245,1578,21205,975,25040,1150,5445,1013,2611,594,2834,610,1071,405,535,229,536,268,927,379,433,198,494,226,545,249,284,146,261,148
86000US33064,"33064",60745,1721,30557,1315,30188,1497,48596,1963,24108,1208,24488,1385,7850,1319,4026,668,3824,888,1270,352,685,223,585,175,741,241,387,159,354,118,2288,549,1351,375,937,273
86000US33065,"33065",57411,1561,26946,1211,30465,1200,48941,1524,22901,1036,26040,1215,5513,928,2790,591,2723,509,1080,332,455,179,625,220,855,426,299,193,556,283,1022,556,501,265,521,310
86000US33066,"33066",16546,722,6831,456,9715,624,14881,721,6076,426,8805,640,1080,343,485,166,595,238,227,135,121,94,106,78,298,168,118,113,180,120,60,71,31,37,29,34
86000US33067,"33067",27106,1382,12771,789,14335,1022,23857,1276,11441,733,12416,889,2355,827,909,347,1446,561,243,215,150,162,93,91,329,138,108,67,221,94,322,314,163,167,159,156
86000US33068,"33068",52025,1489,25228,980,26797,1204,44242,1878,21579,1082,22663,1314,4940,1204,2273,580,2667,717,1140,578,520,323,620,315,629,345,356,237,273,181,1074,663,500,263,574,469
86000US33069,"33069",27857,1387,14660,1175,13197,693,19938,1238,10003,801,9935,752,5422,930,3411,720,2011,338,1295,369,701,227,594,234,487,240,180,78,307,209,715,284,365,142,350,203
86000US33070,"33070",5115,488,2617,268,2498,332,4736,500,2455,286,2281,315,192,116,68,47,124,86,70,50,66,47,4,8,87,59,21,22,66,49,30,37,7,14,23,34
86000US33071,"33071",38845,1200,18672,779,20173,860,32765,1378,15984,835,16781,905,3571,823,1724,438,1847,432,1484,469,567,188,917,318,638,285,234,139,404,200,387,310,163,188,224,205
86000US33073,"33073",35139,967,17320,724,17819,743,28641,1113,14531,701,14110,800,4140,779,1610,321,2530,563,824,351,419,232,405,177,610,262,225,118,385,212,924,505,535,322,389,236
86000US33076,"33076",38655,1087,20005,899,18650,940,32919,1421,17302,1042,15617,928,3202,890,1562,475,1640,481,983,594,363,255,620,390,1321,504,710,251,611,282,230,182,68,66,162,139
86000US33101,"33101",0,14,0,14,0,14,0,14,0,14,0,14,0,14,0,14,0,14,0,14,0,14,0,14,0,14,0,14,0,14,0,14,0,14,0,14
86000US33109,"33109",408,179,203,94,205,93,337,163,159,81,178,88,42,68,29,48,13,20,0,14,0,14,0,14,0,14,0,14,0,14,29,46,15,23,14,23
86000US33122,"33122",190,91,94,41,96,60,47,54,24,28,23,26,55,46,21,24,34,26,0,14,0,14,0,14,13,19,13,19,0,14,75,102,36,42,39,63
86000US33125,"33125",60516,2241,30041,1376,30475,1216,56205,2283,27726,1341,28479,1298,2943,682,1519,406,1424,400,348,175,191,112,157,118,184,115,80,59,104,65,836,283,525,199,311,149
86000US33126,"33126",52291,1969,25126,1319,27165,1182,46279,2165,22278,1383,24001,1200,3739,857,1740,390,1999,577,147,98,99,82,48,53,277,134,192,108,85,60,1849,553,817,278,1032,304
86000US33127,"33127",31495,1876,14941,1190,16554,1130,26612,1612,12211,999,14401,1036,3645,744,1894,493,1751,374,588,331,371,196,217,157,232,126,184,116,48,37,418,249,281,201,137,111
86000US33128,"33128",7876,939,4155,632,3721,506,7071,900,3752,593,3319,500,612,249,232,107,380,188,9,20,9,20,0,19,83,110,61,78,22,32,101,94,101,94,0,19
86000US33129,"33129",13585,1599,6423,939,7162,1088,10674,1104,5299,755,5375,619,1918,843,767,462,1151,556,117,105,68,87,49,55,399,332,154,188,245,275,477,370,135,96,342,335
86000US33130,"33130",29333,1960,14869,1206,14464,1198,24653,1831,12495,1115,12158,1110,2682,614,1439,386,1243,315,336,223,155,105,181,178,551,212,244,126,307,145,1111,525,536,287,575,329
86000US33131,"33131",18063,1252,8924,782,9139,815,12411,1168,5973,700,6438,726,3049,724,1549,403,1500,411,637,245,385,179,252,124,1036,367,645,234,391,171,930,320,372,150,558,224
86000US33132,"33132",13571,1163,7968,812,5603,551,9073,873,5245,614,3828,435,2636,480,1626,289,1010,269,744,515,483,379,261,160,552,203,351,173,201,89,566,240,263,142,303,182
86000US33133,"33133",35042,1907,17472,1086,17570,1126,30283,1940,15048,1094,15235,1128,3421,735,1674,429,1747,383,340,164,150,91,190,85,533,166,286,108,247,97,465,168,314,133,151,78
86000US33134,"33134",39960,1837,18622,1088,21338,1134,34863,1831,16294,1113,18569,1055,3578,693,1574,363,2004,478,380,250,183,110,197,161,510,195,295,132,215,90,629,250,276,120,353,153
86000US33135,"33135",38553,1725,19429,1034,19124,1122,35206,1768,17452,1059,17754,1109,2633,728,1556,421,1077,388,61,51,37,38,24,35,136,87,85,56,51,42,517,212,299,156,218,114
86000US33136,"33136",15720,1137,7814,691,7906,724,12922,1123,6290,668,6632,684,2161,537,1201,317,960,346,132,89,44,54,88,60,292,160,158,150,134,83,213,151,121,86,92,86
86000US33137,"33137",22807,1304,11373,808,11434,904,17499,1134,9077,735,8422,708,3363,726,1519,405,1844,465,417,162,136,90,281,124,693,238,321,143,372,151,835,350,320,169,515,259
86000US33138,"33138",29906,1746,15379,1272,14527,1082,25948,1574,13493,1151,12455,972,2615,706,1100,302,1515,565,360,200,239,143,121,83,399,268,171,130,228,176,584,431,376,255,208,197
86000US33139,"33139",38876,1183,21053,901,17823,817,28967,1358,15829,911,13138,796,5985,705,3020,407,2965,476,529,225,350,189,179,83,1562,389,920,270,642,173,1833,522,934,311,899,310
86000US33140,"33140",19712,1047,9700,606,10012,647,16361,942,7963,541,8398,569,2093,445,1044,295,1049,241,461,218,287,136,174,101,324,136,161,86,163,87,473,178,245,105,228,93
86000US33141,"33141",39342,1272,19328,945,20014,957,30596,1349,14630,896,15966,863,5390,981,2839,590,2551,543,358,203,188,126,170,105,858,269,379,152,479,180,2140,636,1292,439,848,309
86000US33142,"33142",58238,2249,28175,1390,30063,1325,53023,2394,25491,1454,27532,1367,4252,896,2145,494,2107,488,205,108,167,97,38,47,235,154,174,117,61,58,523,235,198,111,325,172
86000US33143,"33143",30780,1253,14818,792,15962,908,26292,1282,12762,735,13530,902,2239,485,936,247,1303,306,608,284,314,169,294,172,621,190,349,126,272,130,1020,524,457,256,563,372
86000US33144,"33144",29201,1764,13816,1083,15385,1013,27122,1761,12784,1037,14338,1040,1545,439,689,223,856,337,93,91,84,89,9,20,137,131,54,54,83,91,304,208,205,161,99,82
86000US33145,"33145",30507,1782,14586,1110,15921,1135,27572,1764,13067,1072,14505,1092,2282,570,1194,354,1088,308,273,133,153,93,120,79,72,58,26,30,46,40,308,170,146,87,162,101
86000US33146,"33146",16386,765,7858,480,8528,560,11768,715,5694,440,6074,501,1373,289,500,137,873,204,1407,233,703,129,704,180,1298,210,665,128,633,158,540,249,296,167,244,120
86000US33147,"33147",47381,2316,22051,1348,25330,1609,43844,2273,20325,1330,23519,1548,2951,594,1424,300,1527,379,219,107,102,71,117,79,213,129,118,94,95,60,154,109,82,72,72,54
86000US33149,"33149",12824,89,6125,285,6699,278,11272,426,5438,337,5834,311,1070,344,520,188,550,198,41,43,7,11,34,36,179,98,58,45,121,68,262,123,102,69,160,77
86000US33150,"33150",29155,1650,14614,1098,14541,973,24695,1555,12218,982,12477,923,3798,823,1977,488,1821,435,240,116,134,81,106,64,49,52,49,52,0,25,373,218,236,146,137,104
86000US33154,"33154",14388,157,6819,465,7569,488,12233,746,5762,541,6471,623,1243,528,629,274,614,311,108,107,45,56,63,53,600,390,271,199,329,206,204,140,112,84,92,75
86000US33155,"33155",46213,1379,21715,1116,24498,836,41778,1376,19405,1036,22373,830,2810,500,1545,360,1265,239,353,173,152,100,201,111,442,229,241,142,201,106,830,416,372,175,458,282
86000US33156,"33156",33223,1086,16821,741,16402,741,29508,1208,15027,778,14481,758,2219,513,1109,280,1110,288,276,137,75,52,201,125,477,233,266,157,211,101,743,322,344,160,399,198
86000US33157,"33157",66610,1829,31745,1110,34865,1239,59596,1856,28263,1213,31333,1175,5570,916,2823,483,2747,520,174,102,78,52,96,67,446,264,163,117,283,160,824,303,418,177,406,196
86000US33158,"33158",6461,519,3328,364,3133,258,6211,559,3233,376,2978,272,210,164,86,89,124,89,0,19,0,19,0,19,17,26,9,13,8,13,23,25,0,19,23,25
86000US33160,"33160",39370,1165,18947,859,20423,800,33750,1166,16148,742,17602,860,2519,454,1284,274,1235,266,908,378,419,256,489,185,648,204,335,125,313,114,1545,428,761,227,784,234
86000US33161,"33161",55419,2001,27014,1279,28405,1202,47702,1961,23250,1143,24452,1195,5402,947,2658,565,2744,544,789,235,292,106,497,209,496,172,267,94,229,128,1030,390,547,272,483,216
86000US33162,"33162",46520,1930,22747,1254,23773,1186,41623,1895,20351,1291,21272,1076,3105,784,1363,367,1742,509,984,450,580,269,404,210,293,259,147,135,146,134,515,275,306,178,209,134
86000US33165,"33165",55241,1829,26371,1302,28870,1087,51881,1888,24841,1300,27040,1097,2730,613,1155,297,1575,409,162,100,126,75,36,52,78,57,50,46,28,38,390,160,199,107,191,92
86000US33166,"33166",24147,1008,12061,608,12086,661,21191,1031,10535,608,10656,666,2189,459,1076,248,1113,335,365,211,210,112,155,114,101,84,81,62,20,27,301,150,159,82,142,83
86000US33167,"33167",20402,1765,9499,1016,10903,1039,18677,1695,8630,1004,10047,1005,1126,429,628,296,498,194,163,279,63,108,100,172,205,197,125,122,80,91,231,177,53,55,178,148
86000US33168,"33168",27163,1694,13512,1109,13651,889,24404,1596,12019,1049,12385,864,2078,601,1109,354,969,311,280,113,178,80,102,54,145,82,76,60,69,50,256,127,130,95,126,79
86000US33169,"33169",41141,1841,18844,1068,22297,1178,36848,1988,17146,1072,19702,1280,3172,787,1304,367,1868,511,516,229,181,125,335,154,167,95,42,26,125,88,438,346,171,173,267,183
86000US33170,"33170",13961,1438,6417,718,7544,947,12904,1353,5799,665,7105,918,827,450,433,259,394,213,4,8,0,21,4,8,46,49,40,47,6,9,180,160,145,155,35,33
86000US33172,"33172",42943,1541,21177,1020,21766,1082,37412,1658,18563,1054,18849,1088,3715,671,1851,409,1864,394,266,225,104,83,162,150,227,165,123,100,104,80,1323,451,536,244,787,307
86000US33173,"33173",32859,1500,15079,852,17780,1068,29382,1594,13415,805,15967,1137,2703,691,1342,401,1361,367,165,97,82,58,83,66,444,268,150,99,294,187,165,94,90,84,75,62
86000US33174,"33174",34121,1574,16040,912,18081,1058,29230,1634,13664,879,15566,1060,2913,834,1347,413,1566,480,646,229,329,155,317,116,448,173,238,113,210,103,884,273,462,173,422,167
86000US33175,"33175",52917,1937,25190,1232,27727,1217,49631,2057,23845,1272,25786,1235,2367,612,974,317,1393,382,104,77,32,39,72,82,109,71,41,33,68,53,706,280,298,158,408,176
86000US33176,"33176",51774,1668,24389,1154,27385,1024,47161,1667,22176,1098,24985,1094,3749,741,1838,398,1911,474,203,94,97,58,106,73,376,223,192,101,184,159,285,192,86,75,199,168
86000US33177,"33177",56985,1623,28350,1025,28635,1210,51779,1547,25686,1070,26093,1056,3819,837,1729,344,2090,573,282,113,197,82,85,55,350,212,220,129,130,97,755,353,518,271,237,168
86000US33178,"33178",51641,917,24519,729,27122,791,41926,1442,20501,886,21425,955,5310,1011,2041,388,3269,783,224,103,100,56,124,67,684,313,404,195,280,141,3497,987,1473,493,2024,548
86000US33179,"33179",43789,1837,20917,1165,22872,1200,37433,1842,17853,1134,19580,1160,4531,1057,2347,586,2184,568,846,401,392,176,454,292,295,157,73,55,222,143,684,358,252,137,432,276
86000US33180,"33180",32155,1035,15331,732,16824,736,28172,1240,13161,787,15011,829,1885,467,1067,296,818,222,684,307,414,199,270,138,568,224,279,135,289,134,846,326,410,173,436,175
86000US33181,"33181",19792,1341,10153,889,9639,857,14942,1142,7795,792,7147,658,2894,790,1348,429,1546,517,506,202,330,166,176,113,566,201,264,138,302,126,884,411,416,185,468,280
86000US33182,"33182",16490,1081,9183,1005,7307,415,14782,873,8040,771,6742,392,1229,390,763,210,466,243,294,199,251,196,43,32,66,55,49,48,17,26,119,99,80,61,39,46
86000US33183,"33183",36252,1285,16896,963,19356,897,32612,1284,15066,953,17546,807,2374,651,1169,426,1205,332,32,31,28,30,4,6,199,144,126,109,73,59,1035,582,507,321,528,338
86000US33184,"33184",21561,1639,10424,933,11137,892,20077,1491,9717,866,10360,814,1194,499,553,238,641,298,16,18,5,9,11,15,46,31,14,22,32,21,228,126,135,87,93,62
86000US33185,"33185",31132,1336,15003,866,16129,874,28749,1436,13818,928,14931,882,1694,544,872,283,822,289,132,153,92,103,40,51,178,141,92,65,86,87,379,154,129,75,250,125
86000US33186,"33186",68105,2491,31518,1431,36587,1633,61823,2561,28374,1374,33449,1652,4939,981,2494,549,2445,567,224,112,127,77,97,90,265,132,145,92,120,65,854,370,378,195,476,248
86000US33187,"33187",19218,1234,10041,751,9177,809,17698,1333,9219,830,8479,812,1123,583,661,433,462,222,82,69,47,51,35,46,56,53,0,21,56,53,259,165,114,83,145,130
86000US33189,"33189",25093,1497,12630,971,12463,845,22996,1541,11692,1008,11304,834,1722,517,764,292,958,314,83,102,40,54,43,52,224,154,114,80,110,89,68,70,20,27,48,62
86000US33190,"33190",15981,940,7883,567,8098,641,13539,1069,6769,626,6770,649,2074,668,940,303,1134,401,40,52,34,51,6,10,54,61,0,21,54,61,274,267,140,152,134,126
86000US33193,"33193",49538,1404,24173,1148,25365,860,45034,1429,22064,1126,22970,814,3280,916,1596,481,1684,500,112,93,60,58,52,61,407,371,166,160,241,248,705,271,287,134,418,191
86000US33194,"33194",8010,1131,5022,775,2988,580,6485,1088,3705,644,2780,583,612,354,433,261,179,125,789,321,789,321,0,19,37,51,23,53,14,21,87,144,72,142,15,25
86000US33196,"33196",52115,1938,25177,1354,26938,1123,45662,1915,21947,1365,23715,1050,4579,984,2174,481,2405,593,158,95,105,58,53,51,465,213,203,102,262,148,1251,576,748,469,503,215
86000US33301,"33301",14916,1006,8192,604,6724,660,11211,950,6014,574,5197,578,2284,518,1281,344,1003,300,613,250,353,131,260,142,586,224,387,174,199,98,222,148,157,100,65,56
86000US33304,"33304",18177,1182,9871,854,8306,695,14635,1178,8030,825,6605,705,1789,370,960,249,829,221,595,239,336,157,259,135,690,254,394,154,296,155,468,341,151,152,317,216
86000US33305,"33305",12117,788,7588,616,4529,390,9795,792,6029,580,3766,398,1605,388,1120,329,485,150,82,50,57,41,25,23,507,177,333,139,174,88,128,44,49,20,79,35
86000US33306,"33306",3113,381,1745,280,1368,205,2715,355,1492,262,1223,189,322,158,196,93,126,80,0,14,0,14,0,14,58,45,48,37,10,15,18,26,9,13,9,13
86000US33308,"33308",27197,903,14118,700,13079,627,22575,781,11597,577,10978,508,2375,420,1128,308,1247,245,849,336,469,174,380,215,1158,341,804,228,354,169,240,127,120,74,120,79
86000US33309,"33309",40278,1966,20207,1393,20071,1181,32460,1858,16144,1256,16316,1138,5458,1115,2818,605,2640,627,703,251,409,180,294,165,812,270,357,188,455,163,845,388,479,270,366,221
86000US33311,"33311",74924,2752,34528,1595,40396,1926,62539,2527,28433,1355,34106,1742,10220,1856,4733,836,5487,1190,1362,331,838,253,524,188,517,226,331,150,186,123,286,126,193,102,93,63
86000US33312,"33312",54690,1933,28186,1512,26504,1437,46642,1882,23849,1459,22793,1281,4522,1135,2690,754,1832,528,1477,624,733,312,744,383,873,304,493,193,380,155,1176,442,421,209,755,283
86000US33313,"33313",61795,2297,28754,1536,33041,1605,52920,2387,24313,1563,28607,1584,6379,1214,3053,722,3326,681,902,328,430,200,472,178,513,257,283,159,230,145,1081,338,675,277,406,175
86000US33314,"33314",26999,1100,13597,917,13402,822,21377,1425,11054,954,10323,755,4048,923,1816,486,2232,638,413,148,161,78,252,130,983,349,500,202,483,221,178,114,66,82,112,79
86000US33315,"33315",13711,1049,7466,798,6245,556,10903,961,5907,670,4996,516,2054,631,1126,478,928,262,280,194,217,170,63,51,333,173,116,84,217,108,141,107,100,70,41,63
86000US33316,"33316",9675,698,5484,460,4191,382,7922,681,4597,440,3325,371,821,227,311,124,510,144,344,207,190,121,154,101,455,167,306,128,149,71,133,106,80,63,53,55
86000US33317,"33317",38010,1556,19502,1111,18508,1014,32584,1693,16851,1080,15733,1020,2885,815,1400,436,1485,530,1008,451,579,398,429,197,897,600,388,261,509,363,636,386,284,224,352,216
86000US33319,"33319",46112,1795,21007,1245,25105,1083,38299,1682,17546,1123,20753,1101,5315,914,2344,559,2971,506,649,307,296,169,353,190,836,277,456,167,380,151,1013,348,365,154,648,250
86000US33321,"33321",46973,1055,21637,924,25336,824,39279,1481,17989,954,21290,1001,5623,1050,2635,531,2988,657,498,210,306,158,192,109,692,358,344,200,348,196,881,570,363,325,518,318
86000US33322,"33322",38746,1389,17568,727,21178,959,33633,1435,14914,779,18719,945,3077,602,1593,364,1484,329,739,267,407,147,332,159,469,162,209,111,260,103,828,388,445,224,383,183
86000US33323,"33323",21396,1182,9687,701,11709,749,18757,1078,8443,603,10314,715,1605,388,835,252,770,205,346,163,142,86,204,120,308,150,92,60,216,122,380,208,175,117,205,109
86000US33324,"33324",48424,1362,21972,962,26452,907,38620,1722,17261,961,21359,1086,6513,1045,3237,606,3276,606,1230,405,661,278,569,201,981,304,324,120,657,225,1080,584,489,323,591,289
86000US33325,"33325",29256,1169,15052,852,14204,741,25921,1212,13208,882,12713,751,2098,702,1083,445,1015,340,510,201,323,164,187,111,296,176,178,144,118,81,431,309,260,242,171,104
86000US33326,"33326",32745,1126,15595,711,17150,871,27881,1181,13373,699,14508,949,2434,671,1113,328,1321,380,410,288,206,150,204,152,662,317,376,176,286,156,1358,499,527,205,831,372
86000US33327,"33327",23728,1269,11402,851,12326,754,20017,1520,9642,913,10375,956,1458,704,703,338,755,404,402,262,223,142,179,137,262,248,100,118,162,139,1589,713,734,345,855,411
86000US33328,"33328",29322,1324,14040,718,15282,946,25462,1167,12473,655,12989,781,2042,561,858,280,1184,368,808,293,378,168,430,195,850,396,238,131,612,397,160,110,93,83,67,52
86000US33330,"33330",15616,1054,7732,767,7884,567,13487,1013,6731,753,6756,522,1531,564,685,258,846,348,278,158,168,106,110,72,307,256,135,103,172,171,13,25,13,25,0,21
86000US33331,"33331",25522,1260,12761,770,12761,832,22141,1305,11206,821,10935,803,1958,623,884,320,1074,345,335,275,175,145,160,139,375,208,206,127,169,105,713,321,290,124,423,231
86000US33332,"33332",11552,1152,5630,660,5922,662,10361,1166,5037,675,5324,654,698,323,346,167,352,192,99,83,75,76,24,26,285,231,99,86,186,157,109,91,73,67,36,39
86000US33334,"33334",29064,1482,15931,819,13133,1001,24275,1409,13551,794,10724,885,3231,611,1570,299,1661,443,367,224,197,110,170,139,554,258,284,148,270,143,637,468,329,214,308,295
86000US33351,"33351",35075,1210,16278,861,18797,1020,30164,1438,14033,954,16131,1006,4271,991,1998,594,2273,609,220,134,88,61,132,91,209,174,92,85,117,97,211,146,67,67,144,129
86000US33401,"33401",28210,1087,13279,695,14931,774,21169,994,10163,606,11006,658,3471,572,1620,344,1851,362,1430,424,545,165,885,316,1303,328,496,154,807,235,837,384,455,234,382,193
86000US33403,"33403",12747,820,6228,734,6519,567,11138,933,5353,649,5785,604,1211,559,586,336,625,302,168,121,97,83,71,58,150,133,120,131,30,38,80,118,72,117,8,12
86000US33404,"33404",28835,810,13833,636,15002,526,24968,939,12196,647,12772,541,2427,541,992,263,1435,370,502,172,237,109,265,95,646,288,303,119,343,199,292,194,105,67,187,153
86000US33405,"33405",20429,965,10207,679,10222,642,18892,982,9434,673,9458,652,954,300,537,187,417,165,69,48,36,35,33,26,129,76,62,47,67,45,385,238,138,114,247,166
86000US33406,"33406",27222,1253,14031,835,13191,882,23268,1416,11664,935,11604,883,2642,641,1548,416,1094,313,316,131,292,129,24,27,329,158,162,90,167,92,667,367,365,212,302,220
86000US33407,"33407",30903,1555,15257,939,15646,933,25233,1482,12200,818,13033,911,3698,604,2035,386,1663,338,842,279,432,180,410,152,377,160,149,72,228,131,753,397,441,297,312,235
86000US33408,"33408",18168,496,8924,397,9244,405,15976,567,7809,388,8167,439,1292,272,713,189,579,133,202,99,89,47,113,67,611,195,281,110,330,125,87,59,32,29,55,35
86000US33409,"33409",32699,1528,15660,950,17039,972,26534,1704,12734,886,13800,1026,3564,743,1622,434,1942,523,974,328,605,295,369,137,1126,344,464,162,662,255,501,237,235,141,266,154
86000US33410,"33410",34593,1373,15747,924,18846,1001,28727,1247,13119,802,15608,864,3562,656,1514,298,2048,520,843,408,458,269,385,171,1027,336,437,137,590,249,434,202,219,149,215,115
86000US33411,"33411",71679,1798,34445,1074,37234,1242,62681,1814,30445,1046,32236,1211,5943,965,2770,513,3173,590,998,297,407,145,591,222,1273,415,525,181,748,271,784,347,298,167,486,233
86000US33412,"33412",15354,983,8111,625,7243,582,13687,977,7279,634,6408,543,1052,576,513,314,539,282,291,176,192,126,99,61,206,127,120,86,86,57,118,105,7,11,111,103
86000US33413,"33413",17100,1111,8409,700,8691,649,13682,1237,6865,706,6817,705,2501,711,1070,315,1431,453,219,127,99,68,120,85,346,209,196,127,150,107,352,340,179,161,173,198
86000US33414,"33414",60987,1076,28460,910,32527,844,52272,1657,24542,1023,27730,1046,5093,1143,2271,517,2822,724,1498,581,624,280,874,342,1708,572,757,255,951,368,416,186,266,149,150,104
86000US33415,"33415",50904,1518,24196,1010,26708,1082,43753,1467,20924,991,22829,1014,5046,934,2119,470,2927,558,365,170,183,112,182,108,851,468,423,294,428,207,889,270,547,201,342,159
86000US33417,"33417",33382,1290,15896,1102,17486,898,27734,1350,13298,1024,14436,974,3400,847,1459,506,1941,500,597,273,179,89,418,231,955,324,381,128,574,240,696,307,579,306,117,90
86000US33418,"33418",40595,1205,19517,847,21078,840,34907,1157,16715,798,18192,818,3226,627,1484,317,1742,363,927,324,510,203,417,193,1042,298,483,162,559,202,493,280,325,228,168,117
86000US33426,"33426",23569,1076,11013,772,12556,792,18446,1095,8570,687,9876,724,3639,885,1857,506,1782,496,709,293,317,145,392,191,480,308,95,61,385,302,295,247,174,158,121,109
86000US33428,"33428",41207,1395,20277,1017,20930,821,34890,1377,16927,847,17963,866,2894,679,1502,375,1392,377,1801,518,965,318,836,260,941,346,476,183,465,199,681,383,407,260,274,140
86000US33430,"33430",22732,538,11415,587,11317,500,19317,695,9399,630,9918,581,2444,551,1415,317,1029,288,479,232,260,166,219,124,287,205,205,134,82,88,205,124,136,117,69,65
86000US33431,"33431",21510,1096,10562,665,10948,796,15859,1036,8083,543,7776,709,1878,526,944,318,934,292,2167,300,861,156,1306,220,1150,327,497,184,653,207,456,216,177,90,279,180
86000US33432,"33432",20429,987,9975,681,10454,664,16971,970,8202,689,8769,586,1829,390,884,290,945,261,785,365,391,191,394,217,585,192,374,128,211,92,259,137,124,87,135,107
86000US33433,"33433",40078,1429,18244,919,21834,964,34025,1489,15321,888,18704,958,3470,630,1593,369,1877,392,1241,412,620,229,621,235,1114,290,548,176,566,161,228,110,162,93,66,37
86000US33434,"33434",20394,868,9261,497,11133,550,18160,846,8304,475,9856,538,1006,367,447,152,559,245,530,194,271,120,259,111,574,196,239,97,335,125,124,69,0,25,124,69
86000US33435,"33435",35805,1202,17514,953,18291,891,29608,1243,14332,853,15276,909,3306,596,1600,387,1706,326,978,532,508,293,470,267,1344,443,763,289,581,297,569,232,311,116,258,191
86000US33436,"33436",44129,1598,21316,930,22813,1052,37167,1639,18345,941,18822,1007,4229,836,1746,379,2483,604,605,225,231,115,374,146,1377,556,492,210,885,373,751,472,502,318,249,171
86000US33437,"33437",37921,1395,17708,909,20213,884,33016,1293,15008,777,18008,842,2333,719,1197,403,1136,430,720,311,430,198,290,130,1554,493,867,415,687,175,298,129,206,94,92,55
86000US33438,"33438",367,182,185,82,182,112,358,181,176,80,182,112,0,14,0,14,0,14,0,14,0,14,0,14,0,14,0,14,0,14,9,13,9,13,0,14
86000US33440,"33440",19517,1011,10377,718,9140,580,16315,1149,8474,786,7841,700,1449,524,687,280,762,321,728,289,402,192,326,182,200,199,122,159,78,63,825,603,692,577,133,119
86000US33441,"33441",27069,1146,12852,709,14217,700,21004,1105,9682,674,11322,652,3276,622,1858,377,1418,332,1366,414,644,239,722,303,785,248,434,144,351,175,638,383,234,195,404,245
86000US33442,"33442",28605,925,13071,599,15534,787,22799,957,10273,520,12526,730,3391,861,1510,427,1881,575,991,295,530,168,461,175,821,309,419,190,402,164,603,318,339,182,264,163
86000US33444,"33444",24429,972,11894,706,12535,720,20055,1093,9764,680,10291,763,2621,618,1293,364,1328,376,851,316,339,162,512,244,575,205,335,149,240,102,327,181,163,95,164,125
86000US33445,"33445",31529,1061,14678,672,16851,896,25975,1021,12185,614,13790,795,3156,578,1463,339,1693,381,753,273,339,126,414,195,1318,309,630,173,688,205,327,144,61,36,266,129
86000US33446,"33446",25877,1305,12374,805,13503,707,21800,1115,10474,671,11326,618,2053,648,1026,434,1027,321,536,301,209,134,327,183,1248,361,553,192,695,230,240,138,112,78,128,107
86000US33449,"33449",12223,953,6076,636,6147,571,11273,921,5615,619,5658,533,574,381,342,234,232,187,96,141,48,70,48,72,251,183,71,56,180,130,29,43,0,21,29,43
86000US33455,"33455",22122,1015,10870,673,11252,670,19520,1029,9714,672,9806,666,1069,391,526,220,543,216,850,313,299,134,551,229,510,199,179,98,331,137,173,142,152,134,21,23
86000US33458,"33458",58225,959,28821,1004,29404,883,49724,1390,25003,1050,24721,912,4834,992,2214,525,2620,610,1388,377,497,169,891,309,1938,549,1027,350,911,264,341,190,80,72,261,135
86000US33460,"33460",32121,764,16648,741,15473,563,27097,1087,14176,764,12921,705,3656,743,1715,339,1941,483,534,202,340,158,194,80,441,225,252,132,189,117,393,204,165,112,228,149
86000US33461,"33461",47200,1556,23330,1147,23870,1062,39647,1617,19831,1058,19816,1115,4920,742,2259,390,2661,504,1162,543,602,368,560,287,764,310,437,208,327,165,707,320,201,118,506,262
86000US33462,"33462",32818,1243,17311,945,15507,702,27503,1357,14482,967,13021,782,3584,878,1809,485,1775,504,857,370,494,252,363,189,638,242,380,173,258,105,236,122,146,97,90,48
86000US33463,"33463",62750,1443,30431,942,32319,1110,55743,1461,27251,994,28492,990,5086,863,2168,440,2918,612,714,218,427,179,287,127,526,177,234,96,292,110,681,304,351,191,330,149
86000US33467,"33467",53946,1616,25684,1150,28262,913,47258,1474,22580,994,24678,1022,4266,1067,1902,412,2364,759,1236,455,660,297,576,242,825,281,373,163,452,178,361,293,169,91,192,230
86000US33469,"33469",14826,676,7209,520,7617,474,13150,602,6350,477,6800,453,722,338,395,216,327,155,431,175,225,94,206,97,381,179,147,88,234,115,142,182,92,111,50,79
86000US33470,"33470",27155,1008,13816,698,13339,683,24586,1200,12574,807,12012,670,1320,505,570,248,750,299,700,391,369,223,331,174,498,397,284,256,214,154,51,83,19,31,32,52
86000US33471,"33471",6848,670,3896,370,2952,438,5903,690,3243,368,2660,446,85,63,22,25,63,50,621,247,489,204,132,98,198,148,119,85,79,71,41,65,23,34,18,33
86000US33472,"33472",19830,1234,9448,676,10382,841,17273,1171,8198,639,9075,761,1769,483,798,212,971,354,270,158,203,146,67,63,372,195,176,108,196,128,146,190,73,94,73,96
86000US33473,"33473",11869,1268,5862,811,6007,667,10218,1355,4883,763,5335,720,1178,814,759,575,419,279,156,96,55,45,101,69,317,199,165,118,152,86,0,21,0,21,0,21
86000US33476,"33476",8335,579,4799,476,3536,329,6999,706,3919,528,3080,379,986,388,606,258,380,171,204,94,199,94,5,4,49,60,21,32,28,32,97,104,54,70,43,50
86000US33477,"33477",12551,754,5749,440,6802,501,11123,732,5219,424,5904,490,564,210,189,85,375,151,143,83,48,41,95,52,690,227,273,113,417,145,31,31,20,17,11,17
86000US33478,"33478",13931,907,7186,541,6745,572,13009,941,6726,524,6283,599,649,357,365,218,284,164,76,70,33,35,43,41,181,204,62,71,119,139,16,28,0,21,16,28
86000US33480,"33480",10006,150,4522,216,5484,208,8942,215,4145,208,4797,226,694,177,288,89,406,116,55,33,18,15,37,28,220,85,39,26,181,80,95,53,32,27,63,37
86000US33483,"33483",12640,722,6282,504,6358,462,9773,719,4902,425,4871,419,1553,360,664,205,889,247,292,161,156,80,136,141,792,431,430,263,362,200,230,118,130,75,100,72
86000US33484,"33484",26140,935,11879,646,14261,619,21583,988,9722,640,11861,586,2015,406,969,254,1046,254,563,174,210,96,353,117,1718,441,860,277,858,219,261,196,118,90,143,108
86000US33486,"33486",23105,1200,10944,667,12161,849,19524,1094,9310,633,10214,677,1944,663,857,273,1087,453,737,311,363,151,374,213,623,310,287,116,336,232,277,181,127,116,150,134
86000US33487,"33487",20516,937,10020,543,10496,715,16925,982,8195,584,8730,579,1839,606,792,270,1047,495,649,326,351,224,298,171,1000,332,633,257,367,141,103,101,49,57,54,84
86000US33493,"33493",5512,136,4695,176,817,133,4151,232,3454,218,697,124,237,103,135,62,102,57,1074,209,1066,208,8,11,34,33,30,32,4,7,16,17,10,14,6,9
86000US33496,"33496",22337,925,9635,602,12702,672,19688,949,8794,579,10894,680,1256,333,474,170,782,230,574,307,104,75,470,275,693,314,211,97,482,257,126,114,52,61,74,69
86000US33498,"33498",15095,770,7313,498,7782,511,12979,754,6351,474,6628,511,1040,352,429,163,611,217,195,165,89,76,106,98,515,373,244,182,271,195,366,285,200,168,166,136
86000US33503,"33503",162,135,72,69,90,67,162,135,72,69,90,67,0,14,0,14,0,14,0,14,0,14,0,14,0,14,0,14,0,14,0,14,0,14,0,14
86000US33510,"33510",29023,1314,14279,907,14744,818,24740,1370,12120,965,12620,752,2532,611,1150,323,1382,344,564,252,396,201,168,96,719,379,353,195,366,218,468,326,260,177,208,157
86000US33511,"33511",58279,1834,28035,1124,30244,1207,46904,1958,22598,1223,24306,1142,6504,846,3174,483,3330,519,1709,437,784,224,925,256,2197,558,1044,328,1153,296,965,388,435,229,530,198
86000US33513,"33513",12478,870,7139,523,5339,530,10568,856,5867,509,4701,493,563,214,373,154,190,112,1032,244,772,180,260,113,221,160,67,45,154,144,94,82,60,62,34,30
86000US33514,"33514",2646,999,1150,409,1496,620,2411,864,1078,404,1333,493,147,151,46,46,101,143,68,100,24,35,44,66,18,30,0,14,18,30,2,6,2,6,0,14
86000US33521,"33521",547,190,235,98,312,117,454,164,193,89,261,103,0,14,0,14,0,14,93,111,42,56,51,59,0,14,0,14,0,14,0,14,0,14,0,14
86000US33523,"33523",18619,1167,8953,708,9666,659,16834,1229,8060,742,8774,695,857,291,470,160,387,149,645,217,292,139,353,122,207,86,78,41,129,68,76,39,53,24,23,28
86000US33525,"33525",20428,1139,10336,761,10092,629,17954,1107,9075,742,8879,617,891,276,404,136,487,183,740,194,420,120,320,126,687,228,332,119,355,145,156,63,105,50,51,33
86000US33527,"33527",14890,1089,7887,767,7003,578,13219,1062,6871,672,6348,598,808,315,456,193,352,155,363,237,191,124,172,134,243,156,120,65,123,112,257,262,249,261,8,12
86000US33534,"33534",16902,864,7967,527,8935,592,13982,962,6832,574,7150,625,2075,557,851,282,1224,347,197,166,92,77,105,91,591,372,162,110,429,329,57,55,30,33,27,43
86000US33538,"33538",4671,541,2210,304,2461,368,4158,532,2035,306,2123,345,177,99,63,49,114,75,252,141,89,59,163,93,84,72,23,22,61,60,0,14,0,14,0,14
86000US33540,"33540",8544,761,4178,390,4366,474,7024,667,3562,380,3462,392,658,345,254,132,404,244,321,141,144,86,177,94,382,171,140,76,242,114,159,100,78,51,81,52
86000US33541,"33541",21384,976,10309,633,11075,574,17730,868,8578,583,9152,515,1311,505,644,273,667,260,1467,516,678,296,789,245,706,158,331,78,375,97,170,75,78,40,92,40
86000US33542,"33542",21882,796,10214,460,11668,581,18506,918,8604,474,9902,670,1983,429,929,250,1054,248,716,326,367,193,349,156,575,176,266,104,309,104,102,72,48,37,54,44
86000US33543,"33543",27980,1103,13323,668,14657,706,24003,1147,11491,675,12512,701,1391,371,631,221,760,208,1269,342,652,217,617,159,990,378,437,163,553,235,327,205,112,71,215,168
86000US33544,"33544",27862,1065,14229,806,13633,678,24109,1076,12172,781,11937,708,1513,474,828,312,685,226,1446,416,788,256,658,224,679,288,411,198,268,135,115,105,30,33,85,82
86000US33545,"33545",19408,865,9409,586,9999,533,16666,889,8146,611,8520,518,1011,373,623,253,388,151,1018,449,374,234,644,289,543,269,237,108,306,171,170,93,29,35,141,75
86000US33547,"33547",25735,938,12676,585,13059,619,22365,1023,10948,626,11417,621,1807,429,1017,268,790,231,484,219,241,122,243,135,993,454,435,233,558,278,86,83,35,34,51,56
86000US33548,"33548",7093,478,3348,292,3745,289,6247,511,2985,304,3262,290,571,245,261,117,310,145,140,83,62,44,78,52,135,122,40,48,95,102,0,19,0,19,0,19
86000US33549,"33549",17889,919,9494,628,8395,522,15852,907,8390,607,7462,523,895,326,553,241,342,131,716,297,367,172,349,156,339,172,149,93,190,97,87,116,35,59,52,62
86000US33556,"33556",23041,1187,11472,707,11569,692,20900,1165,10340,674,10560,667,1125,450,624,268,501,212,507,295,302,166,205,154,502,249,199,110,303,164,7,12,7,12,0,25
86000US33558,"33558",23995,806,11820,635,12175,574,21205,817,10449,647,10756,541,1543,508,738,270,805,267,779,262,403,146,376,170,334,169,177,103,157,84,134,90,53,43,81,59
86000US33559,"33559",18261,1207,8857,837,9404,719,14814,1206,7192,784,7622,692,1599,464,889,309,710,248,1042,436,529,241,513,226,563,402,195,127,368,290,243,315,52,64,191,255
86000US33563,"33563",27663,959,13196,691,14467,743,23338,1173,11235,691,12103,857,2754,799,1322,442,1432,459,997,363,390,140,607,257,383,188,194,121,189,101,191,180,55,55,136,138
86000US33565,"33565",17680,1032,8682,661,8998,586,15159,922,7257,499,7902,573,1632,501,839,310,793,241,483,167,264,84,219,96,147,99,71,60,76,52,259,344,251,344,8,12
86000US33566,"33566",21151,1217,10468,736,10683,685,17933,1182,8919,721,9014,643,1815,565,846,311,969,299,703,279,337,172,366,166,615,284,320,160,295,134,85,78,46,44,39,43
86000US33567,"33567",11970,873,6184,581,5786,522,10679,844,5265,533,5414,509,696,336,463,265,233,119,277,155,157,89,120,87,44,34,33,30,11,15,274,187,266,185,8,12
86000US33569,"33569",28093,1281,13469,691,14624,826,24336,1391,11574,731,12762,898,1882,552,953,327,929,295,550,273,262,153,288,165,1196,496,636,288,560,228,129,116,44,45,85,84
86000US33570,"33570",29553,1486,15078,1024,14475,933,26044,1385,13383,974,12661,881,2147,507,1091,293,1056,287,337,152,161,95,176,98,873,297,395,142,478,204,152,113,48,51,104,71
86000US33572,"33572",20175,805,9895,520,10280,517,16584,792,8089,481,8495,472,2330,552,1162,311,1168,318,436,276,260,163,176,119,806,284,374,125,432,188,19,20,10,14,9,15
86000US33573,"33573",23077,766,9898,506,13179,544,19845,827,8452,481,11393,581,1517,307,648,179,869,189,521,161,244,101,277,79,1011,258,481,144,530,147,183,142,73,69,110,80
86000US33576,"33576",4529,372,2114,235,2415,206,3849,356,1776,207,2073,212,251,123,118,63,133,75,228,125,94,54,134,91,137,74,87,51,50,33,64,51,39,31,25,23
86000US33578,"33578",51657,2014,24512,1293,27145,1163,41958,2046,19747,1245,22211,1078,5775,1091,3119,603,2656,600,1202,316,570,191,632,208,2093,741,823,238,1270,591,629,349,253,154,376,222
86000US33579,"33579",35643,1505,17601,943,18042,936,29815,1655,14750,995,15065,925,3416,969,1718,527,1698,517,1006,411,495,244,511,221,1218,513,616,265,602,274,188,133,22,29,166,122
86000US33584,"33584",26548,1409,12803,839,13745,845,22637,1290,10915,712,11722,801,2552,840,1215,435,1337,503,478,275,243,158,235,162,591,376,267,166,324,226,290,281,163,205,127,91
86000US33585,"33585",1119,230,486,123,633,158,957,224,451,121,506,153,51,58,0,14,51,58,89,45,32,23,57,43,3,5,3,5,0,14,19,38,0,14,19,38
86000US33592,"33592",11418,861,5745,419,5673,638,10250,873,5091,434,5159,631,703,206,392,130,311,122,269,189,162,132,107,70,178,85,88,55,90,53,18,16,12,14,6,9
86000US33594,"33594",34682,1569,16874,1057,17808,782,30190,1492,14776,1023,15414,724,2910,589,1362,369,1548,300,418,157,171,72,247,110,931,346,487,209,444,168,233,185,78,65,155,154
86000US33596,"33596",30679,1065,14769,739,15910,724,27293,1054,13233,723,14060,712,2151,548,924,297,1227,306,203,105,72,52,131,68,954,443,510,259,444,205,78,61,30,33,48,49
86000US33597,"33597",7649,792,3688,513,3961,439,6736,825,3312,514,3424,433,686,380,313,198,373,229,86,50,42,36,44,35,98,78,21,26,77,67,43,66,0,19,43,66
86000US33598,"33598",19906,1053,10138,846,9768,498,17034,1055,8615,777,8419,496,1582,556,791,285,791,333,420,209,213,120,207,96,736,358,408,308,328,117,134,223,111,221,23,33
86000US33602,"33602",15465,806,8171,495,7294,521,10954,690,5709,421,5245,444,2833,465,1524,296,1309,277,601,149,380,126,221,111,865,235,436,143,429,171,212,98,122,75,90,60
86000US33603,"33603",21175,1121,10002,751,11173,698,17227,1126,8152,684,9075,706,2807,478,1255,302,1552,285,553,258,277,140,276,167,257,143,134,76,123,74,331,237,184,166,147,88
86000US33604,"33604",39203,1609,19445,1052,19758,981,31583,1585,15489,983,16094,970,5008,727,2620,442,2388,419,1733,531,885,305,848,311,636,237,342,128,294,147,243,165,109,97,134,82
86000US33605,"33605",17464,864,8349,585,9115,542,14396,914,6897,573,7499,611,2154,450,954,237,1200,326,481,187,297,116,184,87,312,166,145,94,167,91,121,69,56,41,65,48
86000US33606,"33606",20486,989,9552,691,10934,686,12664,939,6059,613,6605,548,3627,512,1402,215,2225,417,1032,336,568,287,464,139,2504,369,1187,240,1317,255,659,263,336,179,323,140
86000US33607,"33607",24152,1272,11070,689,13082,915,19833,1301,9016,677,10817,874,2479,577,1093,271,1386,398,576,229,298,149,278,139,954,278,515,186,439,144,310,197,148,115,162,106
86000US33609,"33609",18188,1119,9368,805,8820,686,14607,1072,7344,679,7263,567,2451,532,1341,461,1110,311,507,217,358,186,149,84,327,189,175,123,152,142,296,300,150,185,146,128
86000US33610,"33610",46439,2280,22023,1267,24416,1360,38973,2232,18629,1258,20344,1319,5102,1066,2204,527,2898,695,772,294,482,192,290,138,1243,502,608,230,635,302,349,212,100,67,249,179
86000US33611,"33611",32781,1209,16928,828,15853,819,26360,1110,13342,766,13018,736,4232,899,2376,594,1856,399,728,232,471,181,257,102,876,337,487,221,389,170,585,290,252,124,333,212
86000US33612,"33612",50916,1605,24784,1103,26132,1178,40325,1708,19414,1087,20911,1174,7323,1165,3725,702,3598,570,1533,395,736,232,797,220,1094,299,574,176,520,179,641,329,335,182,306,188
86000US33613,"33613",35928,1655,18249,1056,17679,1112,26231,1413,13396,858,12835,957,5555,694,2971,456,2584,439,2348,642,987,409,1361,447,978,354,506,193,472,229,816,315,389,134,427,271
86000US33614,"33614",48411,1975,24627,1142,23784,1312,38628,1752,19647,985,18981,1180,6352,1283,3271,830,3081,608,1428,558,751,288,677,332,992,344,513,215,479,223,1011,449,445,210,566,290
86000US33615,"33615",46853,2187,22904,1384,23949,1420,37816,2140,18053,1258,19763,1382,5077,1002,2783,675,2294,473,1450,554,697,260,753,339,1606,625,884,393,722,284,904,330,487,184,417,213
86000US33616,"33616",16677,1074,8449,670,8228,594,12617,1033,6169,589,6448,581,1977,510,1091,317,886,240,769,276,436,191,333,124,818,348,521,240,297,150,496,338,232,176,264,173
86000US33617,"33617",46728,2042,22654,1281,24074,1381,34686,1612,16745,1001,17941,1100,8225,1531,3714,810,4511,880,1522,331,913,220,609,214,1216,374,797,285,419,181,1079,530,485,252,594,346
86000US33618,"33618",27096,1150,13188,645,13908,738,23269,1188,11233,712,12036,717,2670,563,1335,365,1335,294,594,255,279,172,315,123,395,186,211,134,184,116,168,141,130,113,38,36
86000US33619,"33619",39594,2156,20651,1191,18943,1388,29312,1793,14565,1009,14747,1123,7530,1334,4436,757,3094,688,1533,456,916,305,617,251,789,249,542,200,247,129,430,179,192,96,238,123
86000US33620,"33620",5318,620,2112,280,3206,444,1746,318,658,169,1088,234,588,126,290,118,298,80,2130,396,804,177,1326,300,586,113,218,60,368,86,268,99,142,76,126,56
86000US33621,"33621",2708,290,1578,262,1130,265,2199,284,1346,281,853,219,219,147,95,65,124,91,60,80,50,65,10,15,230,204,87,72,143,140,0,14,0,14,0,14
86000US33624,"33624",39424,1362,19071,854,20353,1058,34337,1490,16730,946,17607,1053,3002,599,1318,276,1684,442,1355,643,698,306,657,362,512,211,196,106,316,143,218,139,129,88,89,78
86000US33625,"33625",27112,1209,12730,759,14382,809,23721,1228,11070,789,12651,758,1982,553,996,348,986,354,398,174,212,96,186,109,679,351,275,161,404,251,332,301,177,149,155,164
86000US33626,"33626",30392,1300,14344,702,16048,856,25061,1351,11886,700,13175,826,2512,556,1065,280,1447,356,1197,434,549,259,648,244,1200,351,613,179,587,200,422,192,231,127,191,103
86000US33629,"33629",26624,896,12918,532,13706,663,23205,999,11251,622,11954,655,2516,442,1275,245,1241,260,215,84,99,53,116,66,581,206,229,108,352,140,107,109,64,78,43,61
86000US33634,"33634",22313,1123,10952,715,11361,754,19187,1178,9364,709,9823,745,1647,626,839,291,808,375,457,221,269,128,188,116,660,383,354,214,306,232,362,157,126,89,236,121
86000US33635,"33635",18434,1148,8842,718,9592,724,14656,1120,7051,696,7605,654,2212,640,1019,346,1193,361,711,336,444,243,267,132,833,350,328,157,505,257,22,28,0,21,22,28
86000US33637,"33637",17313,1058,8310,844,9003,748,12991,1159,6035,694,6956,743,2931,686,1403,467,1528,459,628,225,437,193,191,89,622,182,342,147,280,127,141,122,93,90,48,41
86000US33647,"33647",70373,1855,34310,1151,36063,1164,56094,2064,27629,1156,28465,1273,7125,1111,3253,580,3872,675,2752,596,1274,340,1478,393,2767,702,1302,347,1465,412,1635,598,852,355,783,293
86000US33701,"33701",15707,1148,7347,685,8360,653,12022,995,5624,568,6398,557,1835,448,813,275,1022,288,900,298,354,151,546,199,823,254,501,185,322,124,127,87,55,54,72,40
86000US33702,"33702",31608,1374,15140,770,16468,882,27823,1293,13443,811,14380,733,2399,573,1088,286,1311,366,740,333,227,103,513,269,579,208,346,129,233,111,67,68,36,36,31,36
86000US33703,"33703",25412,1021,12383,718,13029,680,22081,1007,10845,660,11236,656,2067,541,894,298,1173,324,357,161,118,80,239,146,556,220,270,115,286,158,351,231,256,199,95,61
86000US33704,"33704",16743,767,8056,541,8687,441,14207,651,6627,405,7580,427,1503,340,883,197,620,198,366,105,185,92,181,75,658,278,360,221,298,113,9,12,1,2,8,12
86000US33705,"33705",28598,1432,13899,856,14699,896,22554,1385,10990,846,11564,841,4006,746,1804,331,2202,513,766,233,442,162,324,122,918,211,445,143,473,156,354,219,218,137,136,102
86000US33706,"33706",16252,109,7854,288,8398,284,13805,376,6599,338,7206,320,1071,270,533,145,538,159,317,143,144,73,173,87,839,231,479,144,360,121,220,138,99,60,121,84
86000US33707,"33707",24593,678,11439,549,13154,551,20830,737,9618,485,11212,559,2262,314,1075,223,1187,209,638,245,289,117,349,165,748,229,370,131,378,135,115,66,87,56,28,26
86000US33708,"33708",16024,600,8159,398,7865,357,13970,541,7047,347,6923,337,1006,227,560,152,446,123,293,110,158,74,135,55,658,139,358,100,300,71,97,54,36,22,61,42
86000US33709,"33709",24516,1067,12042,573,12474,706,21165,1116,10292,608,10873,699,2204,470,1117,263,1087,271,309,141,169,106,140,72,564,214,290,110,274,116,274,155,174,105,100,66
86000US33710,"33710",33966,1140,16437,799,17529,757,29627,1347,14101,775,15526,870,3083,754,1648,496,1435,340,533,193,325,132,208,110,629,223,311,125,318,124,94,67,52,53,42,37
86000US33711,"33711",19559,1477,9080,945,10479,791,16591,1564,7782,921,8809,821,1433,596,683,360,750,372,587,319,199,116,388,274,899,289,402,147,497,170,49,32,14,18,35,26
86000US33712,"33712",24507,1365,11878,962,12629,766,20380,1276,9864,850,10516,756,2581,537,1107,301,1474,311,903,393,528,238,375,203,399,183,233,151,166,97,244,184,146,107,98,116
86000US33713,"33713",32091,1386,16007,846,16084,904,27378,1338,13938,839,13440,774,2722,456,1222,265,1500,301,905,303,335,136,570,223,760,194,366,108,394,164,326,169,146,119,180,132
86000US33714,"33714",21653,1530,10474,851,11179,974,19364,1600,9268,803,10096,1032,1601,677,786,336,815,373,213,111,173,95,40,40,401,208,209,145,192,118,74,46,38,28,36,26
86000US33715,"33715",7286,531,3551,307,3735,296,6378,507,3117,297,3261,273,398,155,158,66,240,106,178,119,116,91,62,40,269,103,125,58,144,60,63,49,35,28,28,24
86000US33716,"33716",18050,1224,8995,828,9055,767,12519,1145,6190,734,6329,648,2517,564,1423,405,1094,286,1262,352,566,207,696,239,1491,392,654,229,837,252,261,181,162,118,99,91
86000US33744,"33744",122,56,99,51,23,26,88,56,77,56,11,25,23,36,11,24,12,27,0,14,0,14,0,14,11,25,11,25,0,14,0,14,0,14,0,14
86000US33755,"33755",26475,1337,12764,774,13711,956,22190,1357,10729,697,11461,954,2799,719,1396,362,1403,478,507,257,259,118,248,209,841,275,325,134,516,203,138,97,55,47,83,71
86000US33756,"33756",33734,1289,15379,761,18355,1055,28020,1380,12689,811,15331,938,4148,990,1920,509,2228,667,745,309,399,223,346,160,740,286,310,147,430,194,81,78,61,60,20,28
86000US33759,"33759",18031,836,8952,542,9079,513,14726,860,7259,519,7467,511,2032,614,966,328,1066,321,432,256,343,240,89,52,841,366,384,160,457,223,0,21,0,21,0,21
86000US33760,"33760",17098,777,8871,581,8227,463,13069,758,6641,496,6428,409,2880,677,1588,415,1292,364,689,238,347,145,342,148,381,164,226,133,155,85,79,79,69,74,10,15
86000US33761,"33761",19691,864,8712,482,10979,625,17220,899,7611,524,9609,618,1426,360,623,205,803,222,200,121,121,101,79,49,798,329,340,147,458,248,47,69,17,29,30,42
86000US33762,"33762",8329,766,5072,654,3257,312,5201,436,2704,344,2497,261,2439,536,1888,463,551,158,405,146,297,122,108,67,247,113,183,82,64,48,37,50,0,19,37,50
86000US33763,"33763",19595,1098,8912,864,10683,645,16010,959,7256,669,8754,618,1517,613,690,290,827,359,360,200,198,111,162,108,1617,745,693,478,924,392,91,91,75,79,16,25
86000US33764,"33764",27070,1203,13750,706,13320,787,21944,969,11272,688,10672,621,2920,651,1511,383,1409,341,641,273,323,153,318,139,1209,321,522,153,687,229,356,322,122,98,234,233
86000US33765,"33765",14616,1162,7161,697,7455,691,12668,1163,6179,709,6489,669,1483,450,741,265,742,312,122,105,108,101,14,19,306,158,111,71,195,131,37,36,22,28,15,23
86000US33767,"33767",7443,496,3575,300,3868,315,6355,455,2983,267,3372,299,420,143,263,85,157,84,95,53,48,34,47,33,546,174,272,93,274,87,27,25,9,14,18,21
86000US33770,"33770",26410,1407,12027,906,14383,865,21912,1318,10084,826,11828,819,2892,642,1264,322,1628,409,466,207,207,143,259,99,991,386,409,191,582,263,149,84,63,43,86,73
86000US33771,"33771",30085,1475,14424,921,15661,917,24997,1304,11886,744,13111,852,3211,647,1596,460,1615,286,339,159,180,94,159,110,1024,322,492,201,532,188,514,412,270,275,244,151
86000US33772,"33772",22957,908,10684,513,12273,625,19960,1086,9189,551,10771,694,1917,443,919,257,998,236,240,121,152,93,88,48,753,282,386,167,367,145,87,72,38,33,49,44
86000US33773,"33773",17497,1029,8409,593,9088,620,15230,976,7423,582,7807,585,1723,431,708,197,1015,277,163,97,110,87,53,35,331,137,143,96,188,90,50,57,25,30,25,28
86000US33774,"33774",17741,1003,8438,539,9303,661,15534,1019,7376,520,8158,651,1416,417,705,244,711,221,205,108,103,81,102,82,410,146,185,86,225,104,176,165,69,62,107,108
86000US33776,"33776",13505,674,6474,522,7031,320,12268,677,5896,497,6372,314,955,305,428,145,527,206,39,34,16,17,23,28,243,121,134,74,109,58,0,21,0,21,0,21
86000US33777,"33777",16626,873,7997,595,8629,538,14874,862,7134,565,7740,523,1256,308,625,172,631,182,182,119,62,46,120,101,272,153,163,105,109,63,42,37,13,15,29,27
86000US33778,"33778",14487,921,6757,417,7730,784,12161,741,5826,456,6335,444,1665,663,585,177,1080,628,53,35,34,27,19,23,549,171,269,99,280,99,59,46,43,36,16,19
86000US33781,"33781",24576,1005,12156,674,12420,653,21378,1058,10493,678,10885,685,2093,631,1055,334,1038,343,363,273,203,169,160,119,691,385,381,209,310,194,51,54,24,28,27,32
86000US33782,"33782",23203,1003,10757,632,12446,678,19865,1101,9145,646,10720,722,2034,647,1061,409,973,317,764,425,292,164,472,293,407,189,234,116,173,84,133,103,25,46,108,86
86000US33785,"33785",5429,168,2697,170,2732,121,4734,217,2373,170,2361,150,379,137,177,88,202,98,93,48,39,24,54,30,169,83,90,51,79,41,54,57,18,21,36,47
86000US33786,"33786",1559,114,754,75,805,76,1258,114,618,75,640,66,91,47,44,24,47,26,48,28,32,24,16,10,98,39,51,24,47,19,64,49,9,9,55,48
86000US33801,"33801",34050,1607,16675,1120,17375,913,26119,1468,13049,960,13070,920,3867,728,1727,399,2140,445,2218,340,1003,217,1215,242,1671,420,844,254,827,251,175,117,52,51,123,85
86000US33803,"33803",29242,1239,13980,694,15262,776,24264,1330,11484,682,12780,793,2789,593,1448,365,1341,323,991,323,483,174,508,197,959,294,447,145,512,184,239,118,118,68,121,63
86000US33805,"33805",25332,1252,12002,759,13330,787,20426,1175,9685,697,10741,737,2371,652,1142,344,1229,380,1102,522,496,242,606,307,1221,400,597,248,624,244,212,148,82,46,130,116
86000US33809,"33809",30064,1473,14525,817,15539,922,25902,1369,12579,780,13323,825,2363,571,1124,335,1239,290,719,281,298,134,421,177,886,351,438,210,448,181,194,104,86,56,108,66
86000US33810,"33810",50567,2257,24968,1373,25599,1358,41779,2039,20609,1200,21170,1255,4547,786,2136,415,2411,544,2117,757,1138,428,979,397,1765,656,875,355,890,353,359,315,210,174,149,143
86000US33811,"33811",22080,1055,10748,656,11332,577,18847,1037,9072,618,9775,566,1812,461,1043,288,769,237,737,234,316,119,421,162,524,263,248,149,276,134,160,133,69,51,91,90
86000US33812,"33812",12943,917,6079,478,6864,612,12200,956,5733,490,6467,618,436,259,244,153,192,117,126,131,50,62,76,75,181,148,52,49,129,112,0,21,0,21,0,21
86000US33813,"33813",37886,1587,18654,1035,19232,932,33170,1488,16236,942,16934,884,2857,711,1548,426,1309,388,861,341,348,174,513,213,812,321,403,219,409,199,186,132,119,94,67,76
86000US33815,"33815",15061,1232,7903,813,7158,614,13201,1269,7058,804,6143,628,929,282,440,166,489,196,387,376,165,137,222,266,329,140,166,85,163,79,215,147,74,53,141,103
86000US33823,"33823",33107,1146,15966,778,17141,740,28817,1438,13893,905,14924,740,2571,711,1434,469,1137,321,693,240,386,141,307,155,851,327,217,114,634,238,175,110,36,35,139,102
86000US33825,"33825",26183,1048,13306,672,12877,651,21805,1264,10974,689,10831,759,2186,538,1163,330,1023,283,1079,405,676,251,403,184,698,295,296,119,402,192,415,316,197,160,218,171
86000US33827,"33827",3023,457,1462,277,1561,254,2574,429,1222,237,1352,252,243,148,137,125,106,62,114,42,54,29,60,28,84,51,49,41,35,27,8,14,0,14,8,14
86000US33830,"33830",28419,1152,14009,760,14410,834,24577,1262,12014,753,12563,843,2175,460,1183,269,992,263,791,388,364,159,427,259,742,323,406,205,336,141,134,102,42,55,92,80
86000US33834,"33834",7502,608,4566,386,2936,384,6945,650,4181,405,2764,392,271,207,152,129,119,92,199,84,184,81,15,18,74,58,42,32,32,27,13,19,7,10,6,9
86000US33837,"33837",30211,1890,14993,1107,15218,1017,26655,1652,13184,933,13471,970,1027,361,454,189,573,220,889,373,409,178,480,231,1153,601,700,457,453,192,487,239,246,143,241,126
86000US33838,"33838",4212,133,2254,273,1958,251,3970,271,2134,305,1836,235,187,168,110,96,77,83,0,14,0,14,0,14,10,15,0,14,10,15,45,71,10,16,35,66
86000US33839,"33839",3309,510,1761,327,1548,245,2876,539,1521,333,1355,258,345,138,179,87,166,75,59,49,34,28,25,25,29,33,27,33,2,5,0,14,0,14,0,14
86000US33841,"33841",8920,412,4473,302,4447,309,8064,455,4067,320,3997,311,602,259,278,127,324,156,72,60,25,26,47,39,175,75,96,55,79,38,7,16,7,16,0,19
86000US33843,"33843",10968,554,6083,373,4885,368,8705,556,4603,351,4102,352,909,230,662,194,247,99,685,251,471,141,214,128,585,203,301,131,284,103,84,54,46,33,38,39
86000US33844,"33844",36339,1369,17667,854,18672,942,32240,1424,15779,874,16461,949,2115,601,1039,310,1076,332,861,307,342,137,519,219,753,307,343,170,410,154,370,207,164,113,206,134
86000US33847,"33847",167,87,81,34,86,56,167,87,81,34,86,56,0,14,0,14,0,14,0,14,0,14,0,14,0,14,0,14,0,14,0,14,0,14,0,14
86000US33848,"33848",981,765,456,395,525,419,954,766,435,394,519,419,0,14,0,14,0,14,27,12,21,16,6,11,0,14,0,14,0,14,0,14,0,14,0,14
86000US33849,"33849",1171,433,610,276,561,229,956,358,514,255,442,178,204,286,85,137,119,152,11,17,11,17,0,14,0,14,0,14,0,14,0,14,0,14,0,14
86000US33850,"33850",8297,630,4105,589,4192,355,7135,676,3511,609,3624,362,545,246,283,172,262,148,308,263,166,152,142,120,243,209,145,118,98,98,66,88,0,19,66,88
86000US33851,"33851",1153,260,526,135,627,153,1127,258,507,132,620,153,26,41,19,31,7,10,0,14,0,14,0,14,0,14,0,14,0,14,0,14,0,14,0,14
86000US33852,"33852",21018,1315,10770,858,10248,661,18458,1290,9398,792,9060,652,1333,560,631,253,702,368,381,216,226,135,155,122,655,309,341,190,314,150,191,238,174,234,17,27
86000US33853,"33853",11587,836,5340,421,6247,601,9649,978,4368,493,5281,647,1304,593,722,368,582,269,153,102,73,66,80,66,418,225,157,94,261,150,63,49,20,20,43,39
86000US33854,"33854",294,137,150,98,144,54,202,107,95,65,107,61,29,34,10,15,19,31,63,101,45,72,18,29,0,14,0,14,0,14,0,14,0,14,0,14
86000US33855,"33855",0,14,0,14,0,14,0,14,0,14,0,14,0,14,0,14,0,14,0,14,0,14,0,14,0,14,0,14,0,14,0,14,0,14,0,14
86000US33856,"33856",270,112,150,63,120,69,231,95,150,63,81,53,39,45,0,14,39,45,0,14,0,14,0,14,0,14,0,14,0,14,0,14,0,14,0,14
86000US33857,"33857",2350,464,1115,274,1235,325,2149,452,996,261,1153,325,94,79,50,53,44,46,70,67,32,31,38,37,37,57,37,57,0,14,0,14,0,14,0,14
86000US33859,"33859",11006,1271,5003,626,6003,905,8985,1124,3993,511,4992,826,1007,418,368,155,639,355,453,221,293,145,160,93,517,250,332,208,185,83,44,45,17,27,27,35
86000US33860,"33860",26481,1564,13545,1050,12936,828,23487,1673,11868,1072,11619,874,1847,788,1183,564,664,263,675,295,364,153,311,173,404,289,115,110,289,208,68,69,15,25,53,62
86000US33865,"33865",958,457,407,200,551,271,925,448,407,200,518,257,33,53,0,14,33,53,0,14,0,14,0,14,0,14,0,14,0,14,0,14,0,14,0,14
86000US33867,"33867",327,153,176,107,151,62,302,154,163,107,139,62,0,14,0,14,0,14,25,38,13,20,12,18,0,14,0,14,0,14,0,14,0,14,0,14
86000US33868,"33868",11987,818,6640,503,5347,447,9764,690,5200,429,4564,374,841,228,527,160,314,107,1135,599,779,335,356,288,239,85,126,55,113,48,8,15,8,15,0,21
86000US33870,"33870",21896,1286,10649,839,11247,730,16926,1224,8294,799,8632,625,2946,762,1489,524,1457,361,1177,427,459,175,718,309,483,227,185,127,298,147,364,331,222,185,142,155
86000US33872,"33872",15909,975,7690,542,8219,598,13665,1073,6562,580,7103,628,1198,376,588,218,610,192,316,134,172,87,144,88,656,219,337,131,319,114,74,75,31,37,43,40
86000US33873,"33873",14085,824,7349,491,6736,486,12992,852,6760,515,6232,538,700,335,423,231,277,166,354,233,145,98,209,157,39,57,21,48,18,29,0,21,0,21,0,21
86000US33875,"33875",11522,956,5612,558,5910,564,10230,906,4956,529,5274,531,554,290,275,164,279,175,247,183,112,88,135,135,299,147,180,79,119,78,192,224,89,139,103,108
86000US33876,"33876",4888,724,2395,377,2493,427,4307,687,2114,341,2193,408,189,172,90,83,99,121,150,116,93,66,57,67,242,175,98,80,144,132,0,14,0,14,0,14
86000US33877,"33877",618,741,355,428,263,315,432,484,267,302,165,189,186,304,88,143,98,162,0,14,0,14,0,14,0,14,0,14,0,14,0,14,0,14,0,14
86000US33880,"33880",40026,2364,19668,1382,20358,1408,35086,2264,17414,1237,17672,1376,2903,757,1314,369,1589,514,701,312,344,214,357,163,1074,455,494,232,580,257,262,161,102,77,160,115
86000US33881,"33881",33872,1295,15883,776,17989,932,29351,1584,13964,948,15387,918,2602,734,961,291,1641,522,976,605,511,360,465,255,803,367,355,161,448,258,140,123,92,93,48,49
86000US33884,"33884",31558,1491,14603,877,16955,973,26611,1368,12247,788,14364,905,2871,796,1314,388,1557,517,947,374,484,218,463,213,792,279,429,186,363,131,337,223,129,90,208,151
86000US33890,"33890",4729,645,2429,363,2300,356,4556,627,2311,354,2245,351,32,23,13,11,19,14,91,76,58,60,33,32,3,7,0,14,3,7,47,71,47,71,0,14
86000US33896,"33896",11584,1297,5683,795,5901,817,8808,1139,4297,663,4511,775,550,223,317,143,233,102,888,284,396,138,492,211,914,443,404,261,510,206,424,400,269,230,155,174
86000US33897,"33897",22567,1852,10292,968,12275,1134,18456,1785,8447,927,10009,1123,809,337,423,198,386,187,1697,597,794,273,903,346,1094,369,437,161,657,276,511,406,191,196,320,235
86000US33898,"33898",16803,1564,8327,845,8476,873,14945,1514,7361,804,7584,860,1381,454,749,275,632,215,140,121,63,50,77,74,305,141,135,72,170,77,32,28,19,25,13,22
86000US33901,"33901",21028,1410,9750,1134,11278,728,16633,1154,7453,774,9180,722,2814,682,1471,473,1343,315,777,351,451,274,326,128,641,248,261,120,380,192,163,123,114,97,49,59
86000US33903,"33903",22506,1251,11010,779,11496,752,19392,1223,9378,763,10014,706,1967,559,1072,353,895,259,236,123,113,71,123,72,801,371,379,216,422,196,110,73,68,41,42,38
86000US33904,"33904",30920,1609,15391,936,15529,917,26854,1502,13417,849,13437,870,2358,496,1176,325,1182,256,375,190,190,108,185,136,1147,249,544,158,603,143,186,137,64,58,122,95
86000US33905,"33905",37170,1894,19724,1170,17446,1162,31103,1626,16449,955,14654,1028,3389,728,1865,425,1524,424,1127,315,665,215,462,175,1317,380,662,209,655,226,234,137,83,53,151,91
86000US33907,"33907",24213,1605,11496,1022,12717,1164,20082,1513,9818,981,10264,1060,2535,480,958,233,1577,341,573,263,237,117,336,198,966,270,463,131,503,192,57,48,20,21,37,33
86000US33908,"33908",36437,1733,16839,1040,19598,1012,32051,1676,14713,1050,17338,954,2270,443,1086,284,1184,254,178,100,105,62,73,70,1808,348,875,213,933,240,130,114,60,69,70,52
86000US33909,"33909",31609,1751,15247,1154,16362,1171,28025,1865,13494,1166,14531,1142,2266,808,1052,395,1214,518,252,188,127,121,125,111,906,472,530,313,376,233,160,152,44,44,116,117
86000US33912,"33912",18500,1039,8795,658,9705,516,16316,941,7810,629,8506,439,1025,271,530,173,495,135,252,146,87,44,165,119,797,321,350,131,447,212,110,66,18,19,92,61
86000US33913,"33913",25400,1277,12559,919,12841,783,20211,1392,9930,894,10281,770,2475,558,1211,306,1264,300,901,246,504,176,397,123,1624,360,795,239,829,247,189,110,119,87,70,47
86000US33914,"33914",38130,1945,19658,1080,18472,1201,33350,2055,17118,1158,16232,1219,2441,787,1479,493,962,343,393,271,161,127,232,197,1330,439,688,262,642,238,616,492,212,251,404,271
86000US33916,"33916",24382,1463,11446,966,12936,849,20293,1319,9695,885,10598,780,2416,553,958,283,1458,384,708,277,338,185,370,158,813,346,374,191,439,178,152,126,81,81,71,66
86000US33917,"33917",29872,1334,14652,1046,15220,817,24875,1187,12082,735,12793,926,2430,586,1087,302,1343,409,207,101,119,68,88,51,2209,873,1274,562,935,370,151,89,90,65,61,49
86000US33919,"33919",30213,1248,13935,827,16278,807,26337,1319,12037,832,14300,840,2107,426,900,247,1207,260,310,133,178,100,132,85,1259,385,722,243,537,185,200,141,98,79,102,79
86000US33920,"33920",6214,682,3050,343,3164,452,5588,607,2702,298,2886,402,321,154,180,97,141,71,129,112,109,98,20,26,63,51,24,22,39,40,113,95,35,48,78,85
86000US33921,"33921",813,275,417,134,396,164,733,237,368,124,365,139,7,12,7,12,0,14,0,14,0,14,0,14,0,14,0,14,0,14,73,85,42,40,31,55
86000US33922,"33922",4103,579,2002,287,2101,366,3605,574,1792,288,1813,347,333,246,112,78,221,178,51,40,30,23,21,21,114,72,68,63,46,40,0,14,0,14,0,14
86000US33924,"33924",195,79,100,69,95,63,130,82,48,41,82,62,0,14,0,14,0,14,0,14,0,14,0,14,25,57,12,29,13,28,40,55,40,55,0,14
86000US33928,"33928",24859,616,12240,494,12619,488,21325,771,10422,559,10903,455,1591,415,795,212,796,236,452,241,328,215,124,83,1327,361,603,173,724,257,164,132,92,76,72,71
86000US33930,"33930",930,482,402,270,528,251,930,482,402,270,528,251,0,14,0,14,0,14,0,14,0,14,0,14,0,14,0,14,0,14,0,14,0,14,0,14
86000US33931,"33931",10537,327,4969,287,5568,225,9337,381,4463,288,4874,233,426,206,103,53,323,175,43,41,34,37,9,14,656,158,327,79,329,102,75,45,42,28,33,22
86000US33935,"33935",23207,1366,12411,958,10796,699,19986,1351,10618,898,9368,720,1480,590,882,374,598,258,611,257,283,120,328,183,471,289,203,151,268,177,659,452,425,326,234,246
86000US33936,"33936",24288,1586,11447,795,12841,1067,20758,1278,9833,754,10925,844,1769,567,828,296,941,361,916,598,397,246,519,364,473,253,183,98,290,210,372,306,206,166,166,152
86000US33944,"33944",219,302,89,118,130,187,219,302,89,118,130,187,0,14,0,14,0,14,0,14,0,14,0,14,0,14,0,14,0,14,0,14,0,14,0,14
86000US33945,"33945",0,14,0,14,0,14,0,14,0,14,0,14,0,14,0,14,0,14,0,14,0,14,0,14,0,14,0,14,0,14,0,14,0,14,0,14
86000US33946,"33946",2104,379,1057,239,1047,195,1814,337,833,175,981,198,113,116,96,106,17,27,70,58,55,52,15,15,107,70,73,53,34,33,0,14,0,14,0,14
86000US33947,"33947",9062,671,4321,335,4741,472,8108,655,3896,336,4212,428,285,155,96,73,189,109,204,135,118,77,86,64,401,211,163,88,238,143,64,74,48,59,16,25
86000US33948,"33948",17020,1029,8130,530,8890,643,15211,1002,7157,488,8054,667,694,267,381,157,313,175,267,137,121,84,146,87,843,344,466,174,377,189,5,7,5,7,0,21
86000US33950,"33950",23188,688,10993,480,12195,517,19498,715,9313,504,10185,488,1164,317,512,184,652,187,973,354,465,162,508,223,1400,420,641,225,759,218,153,97,62,44,91,59
86000US33952,"33952",33208,1413,16416,929,16792,960,27944,1395,13570,891,14374,883,2839,569,1374,328,1465,347,1077,379,691,254,386,180,1293,417,744,287,549,231,55,42,37,35,18,19
86000US33953,"33953",6724,814,3317,437,3407,493,5387,646,2628,301,2759,412,299,321,83,83,216,243,103,121,69,76,34,55,835,419,474,293,361,165,100,95,63,59,37,42
86000US33954,"33954",10448,1045,4994,562,5454,674,9164,1059,4356,574,4808,645,309,164,155,106,154,120,383,194,239,124,144,92,592,222,244,129,348,152,0,21,0,21,0,21
86000US33955,"33955",11331,806,6237,486,5094,467,9558,729,5179,465,4379,410,373,178,242,120,131,71,689,197,505,120,184,125,562,223,255,94,307,186,149,136,56,62,93,82
86000US33956,"33956",3489,411,1754,299,1735,229,2940,408,1526,297,1414,207,362,92,171,47,191,52,41,54,13,23,28,36,146,101,44,43,102,79,0,14,0,14,0,14
86000US33957,"33957",7308,29,3390,207,3918,207,6723,205,3092,210,3631,244,344,162,172,92,172,81,25,33,11,17,14,17,172,80,83,45,89,48,44,47,32,31,12,19
86000US33960,"33960",665,181,349,98,316,100,602,170,316,92,286,95,0,14,0,14,0,14,63,63,33,35,30,30,0,14,0,14,0,14,0,14,0,14,0,14
86000US33965,"33965",1735,223,818,152,917,175,694,127,366,88,328,100,335,136,171,97,164,63,504,146,214,75,290,98,179,87,57,40,122,77,23,27,10,19,13,19
86000US33966,"33966",9958,976,4805,521,5153,622,8439,931,4095,480,4344,574,801,434,230,109,571,384,177,117,134,113,43,42,461,272,293,165,168,123,80,96,53,60,27,43
86000US33967,"33967",24968,1404,12982,1003,11986,679,21443,1278,11052,875,10391,652,1809,536,862,328,947,293,739,327,487,265,252,131,784,425,476,329,308,151,193,117,105,78,88,72
86000US33971,"33971",27721,1550,14088,969,13633,933,23398,1319,11903,850,11495,785,3107,819,1474,452,1633,443,462,205,287,158,175,101,577,226,347,164,230,116,177,110,77,41,100,99
86000US33972,"33972",15414,1397,7472,771,7942,785,13499,1325,6776,724,6723,745,790,348,260,118,530,280,436,296,170,164,266,157,369,175,191,108,178,122,320,194,75,77,245,151
86000US33973,"33973",16457,1243,7782,873,8675,787,14053,1361,6641,889,7412,819,1427,636,772,371,655,325,164,220,91,142,73,95,636,408,224,167,412,293,177,137,54,59,123,122
86000US33974,"33974",17581,1157,8279,700,9302,779,13906,1013,6638,551,7268,695,2227,570,1006,322,1221,385,953,362,411,161,542,287,274,132,119,66,155,86,221,238,105,144,116,114
86000US33976,"33976",17897,1245,8856,762,9041,752,15408,1032,7519,635,7889,692,1570,574,701,299,869,314,200,133,103,92,97,59,436,501,313,355,123,148,283,262,220,236,63,69
86000US33980,"33980",13223,971,5947,596,7276,644,11428,969,5140,560,6288,663,920,320,404,170,516,204,301,199,157,97,144,115,381,183,156,78,225,115,193,146,90,52,103,106
86000US33981,"33981",11338,782,5482,525,5856,549,9884,744,4665,423,5219,546,359,119,140,72,219,92,723,339,459,291,264,121,346,170,211,139,135,71,26,29,7,11,19,21
86000US33982,"33982",10246,823,5472,498,4774,491,8709,728,4398,400,4311,472,548,179,459,171,89,36,636,239,441,188,195,88,300,142,148,82,152,85,53,57,26,28,27,33
86000US33983,"33983",15066,760,7002,497,8064,536,12621,859,5773,522,6848,532,899,307,400,156,499,203,551,286,331,164,220,147,979,354,498,230,481,161,16,26,0,21,16,26
86000US33990,"33990",34315,1982,16025,1213,18290,1266,30953,2053,14448,1214,16505,1264,1695,572,729,278,966,356,464,244,206,120,258,177,1111,448,588,306,523,202,92,62,54,43,38,32
86000US33991,"33991",22214,1612,10483,899,11731,1024,19384,1634,8988,864,10396,1070,1829,629,1026,428,803,264,99,125,37,44,62,86,845,456,432,268,413,219,57,44,0,25,57,44
86000US33993,"33993",27493,1949,14454,1198,13039,1048,23175,1989,12250,1134,10925,1119,2824,937,1257,489,1567,546,585,421,438,301,147,134,866,481,488,319,378,200,43,33,21,17,22,27
86000US34101,"34101",0,14,0,14,0,14,0,14,0,14,0,14,0,14,0,14,0,14,0,14,0,14,0,14,0,14,0,14,0,14,0,14,0,14,0,14
86000US34102,"34102",11532,525,5296,314,6236,355,9948,480,4638,297,5310,316,638,181,226,78,412,144,213,123,93,68,120,71,502,123,252,76,250,80,231,123,87,44,144,97
86000US34103,"34103",13060,858,6110,525,6950,459,10938,796,5126,476,5812,420,916,284,391,132,525,185,352,269,201,166,151,114,609,187,267,108,342,113,245,129,125,84,120,65
86000US34104,"34104",24222,1455,11375,869,12847,839,20718,1430,9619,818,11099,839,1901,567,991,367,910,251,356,188,219,143,137,91,1055,348,454,160,601,257,192,142,92,79,100,91
86000US34105,"34105",17913,1304,8661,843,9252,696,14334,1221,7066,846,7268,619,1881,479,783,326,1098,343,201,125,115,76,86,61,1106,491,496,245,610,299,391,313,201,192,190,229
86000US34108,"34108",16420,769,8016,476,8404,527,13623,774,6644,423,6979,526,1266,371,668,250,598,173,398,175,187,90,211,112,995,255,447,129,548,152,138,95,70,51,68,51
86000US34109,"34109",24132,1411,11196,860,12936,861,19734,1528,9243,825,10491,949,2384,635,1150,400,1234,358,568,270,314,189,254,137,1000,448,403,209,597,278,446,325,86,73,360,273
86000US34110,"34110",23819,1252,11171,673,12648,810,19858,1207,9360,708,10498,752,1511,485,668,235,843,307,730,308,278,130,452,233,1542,513,809,268,733,268,178,150,56,72,122,107
86000US34112,"34112",26854,1343,13286,729,13568,799,23382,1170,11460,653,11922,717,2278,518,1245,319,1033,293,409,168,247,103,162,99,741,231,334,135,407,135,44,46,0,25,44,46
86000US34113,"34113",22040,1295,10936,953,11104,674,19536,1137,9622,882,9914,654,1046,380,546,223,500,196,308,172,207,139,101,56,818,228,363,103,455,155,332,200,198,157,134,75
86000US34114,"34114",18125,1146,9155,850,8970,593,15475,1129,7665,753,7810,623,647,226,401,155,246,116,349,140,190,92,159,75,1403,518,708,349,695,225,251,316,191,308,60,43
86000US34116,"34116",35721,1821,18022,1201,17699,1182,29556,1902,14821,1186,14735,1172,3948,832,1908,470,2040,549,826,409,520,285,306,169,472,227,282,144,190,116,919,425,491,295,428,220
86000US34117,"34117",16865,1162,8649,813,8216,809,15753,1088,7923,736,7830,800,555,484,349,292,206,203,170,160,128,143,42,47,338,203,216,138,122,104,49,67,33,42,16,27
86000US34119,"34119",32442,1842,15426,946,17016,1407,26188,1773,12380,831,13808,1359,2722,780,1385,417,1337,441,1069,570,333,197,736,428,2012,691,1134,429,878,335,451,366,194,142,257,242
86000US34120,"34120",34874,2178,18318,1653,16556,1219,26983,2644,14128,1777,12855,1325,5440,2043,3235,1288,2205,852,882,792,332,254,550,570,1242,652,523,357,719,374,327,306,100,120,227,236
86000US34134,"34134",14984,911,7517,586,7467,518,13530,916,6806,598,6724,501,264,110,102,58,162,84,274,150,126,84,148,78,788,260,412,144,376,137,128,93,71,66,57,40
86000US34135,"34135",47101,942,23529,1003,23572,917,40594,1333,20465,1032,20129,963,2309,657,1049,364,1260,371,940,457,390,217,550,326,2356,684,1163,397,1193,391,902,450,462,241,440,282
86000US34137,"34137",651,409,253,173,398,239,651,409,253,173,398,239,0,14,0,14,0,14,0,14,0,14,0,14,0,14,0,14,0,14,0,14,0,14,0,14
86000US34138,"34138",340,356,106,121,234,244,293,333,59,96,234,244,47,76,47,76,0,14,0,14,0,14,0,14,0,14,0,14,0,14,0,14,0,14,0,14
86000US34139,"34139",204,82,99,49,105,40,195,83,99,49,96,41,4,6,0,14,4,6,5,7,0,14,5,7,0,14,0,14,0,14,0,14,0,14,0,14
86000US34140,"34140",337,328,98,98,239,231,337,328,98,98,239,231,0,14,0,14,0,14,0,14,0,14,0,14,0,14,0,14,0,14,0,14,0,14,0,14
86000US34141,"34141",67,53,53,34,14,24,42,48,28,27,14,24,12,23,12,23,0,14,13,19,13,19,0,14,0,14,0,14,0,14,0,14,0,14,0,14
86000US34142,"34142",30001,1783,16051,1115,13950,1037,24016,1690,12587,1087,11429,887,3194,760,1860,465,1334,437,1094,421,553,324,541,255,1063,557,594,270,469,387,634,334,457,308,177,145
86000US34145,"34145",17823,45,8910,308,8913,304,16094,514,7939,348,8155,423,630,330,342,211,288,148,284,226,193,154,91,94,652,225,357,111,295,132,163,111,79,52,84,65
86000US34201,"34201",3997,541,2021,299,1976,287,3785,524,1925,287,1860,282,31,35,31,35,0,14,0,14,0,14,0,14,93,85,29,34,64,60,88,120,36,58,52,65
86000US34202,"34202",24427,998,11779,592,12648,773,20422,1133,9756,580,10666,822,1462,609,654,303,808,337,1111,410,504,273,607,231,1338,512,802,393,536,164,94,154,63,103,31,51
86000US34203,"34203",38474,2088,18442,1168,20032,1235,32983,2044,15585,1091,17398,1201,3248,937,1668,490,1580,506,1054,328,523,194,531,213,1008,321,573,205,435,174,181,132,93,86,88,73
86000US34205,"34205",31994,1146,14375,701,17619,884,27184,1109,12170,693,15014,826,2838,502,1221,246,1617,367,1019,257,525,165,494,176,659,191,353,132,306,120,294,154,106,72,188,109
86000US34207,"34207",35598,1878,17766,1171,17832,1078,30809,1657,15164,1008,15645,1034,2659,830,1538,530,1121,378,654,282,374,166,280,165,1253,433,594,241,659,267,223,132,96,79,127,94
86000US34208,"34208",40655,1620,19981,1122,20674,968,34408,1779,16745,1055,17663,1049,3439,875,1643,455,1796,479,1402,546,837,358,565,293,1185,560,641,317,544,285,221,112,115,60,106,79
86000US34209,"34209",34981,1253,16661,771,18320,845,28821,1298,13696,810,15125,748,3150,675,1428,364,1722,409,1181,560,684,392,497,194,1676,415,797,261,879,263,153,85,56,41,97,63
86000US34210,"34210",16453,1000,7862,611,8591,642,12595,847,6064,498,6531,556,1492,384,733,241,759,230,513,216,217,116,296,123,1483,623,691,331,792,333,370,226,157,106,213,138
86000US34211,"34211",8868,1205,4474,717,4394,629,6836,958,3212,480,3624,573,876,436,642,381,234,127,545,282,294,209,251,136,552,256,294,155,258,137,59,62,32,41,27,38
86000US34212,"34212",21139,1189,10374,790,10765,873,17358,1369,8636,768,8722,893,1476,421,673,223,803,269,593,335,352,250,241,132,1325,686,574,327,751,443,387,302,139,113,248,220
86000US34215,"34215",596,221,276,113,320,121,580,222,262,115,318,121,0,14,0,14,0,14,2,3,1,3,1,2,14,19,13,19,1,3,0,14,0,14,0,14
86000US34216,"34216",724,174,345,83,379,105,691,175,328,84,363,107,17,30,9,15,8,15,4,6,1,3,3,5,10,16,5,8,5,8,2,4,2,4,0,14
86000US34217,"34217",5068,136,2294,203,2774,205,4364,224,1996,198,2368,222,227,129,100,70,127,91,168,169,20,27,148,168,302,142,173,92,129,70,7,8,5,6,2,3
86000US34219,"34219",24542,1224,11921,894,12621,651,20593,1155,9998,766,10595,613,2047,644,1055,411,992,329,907,318,400,161,507,226,886,382,401,189,485,221,109,105,67,60,42,59
86000US34221,"34221",45957,1651,22710,990,23247,942,38840,1738,19042,1077,19798,892,3486,814,1703,356,1783,537,2296,784,1226,399,1070,464,1295,447,699,247,596,244,40,42,40,42,0,29
86000US34222,"34222",11619,1122,5331,588,6288,690,10017,1104,4577,563,5440,682,432,186,251,127,181,87,111,133,38,42,73,91,1005,341,421,182,584,210,54,63,44,68,10,17
86000US34223,"34223",18290,977,9117,638,9173,508,15867,959,7929,606,7938,490,951,308,532,188,419,145,596,216,224,84,372,159,715,206,354,128,361,108,161,95,78,49,83,48
86000US34224,"34224",16368,874,7967,577,8401,563,14446,867,7146,537,7300,587,676,235,281,119,395,157,483,318,171,128,312,217,749,225,355,127,394,141,14,22,14,22,0,21
86000US34228,"34228",7283,29,3563,106,3720,107,6544,162,3142,144,3402,117,147,72,87,47,60,31,127,75,84,56,43,26,380,113,200,65,180,62,85,50,50,36,35,27
86000US34229,"34229",7569,662,3703,412,3866,380,6588,686,3249,417,3339,371,724,363,292,160,432,226,72,72,32,52,40,48,146,109,102,79,44,38,39,46,28,33,11,18
86000US34231,"34231",30205,1063,14102,699,16103,779,25331,1109,11634,622,13697,808,3060,520,1551,292,1509,338,427,173,189,93,238,112,1252,334,668,177,584,199,135,85,60,46,75,51
86000US34232,"34232",34819,1365,16920,889,17899,813,29220,1269,14284,875,14936,748,3763,674,1661,347,2102,433,1026,230,550,152,476,124,762,197,393,128,369,106,48,53,32,49,16,17
86000US34233,"34233",17578,948,8273,608,9305,654,14860,842,6780,564,8080,571,1771,634,1017,414,754,276,332,210,203,150,129,91,615,244,273,137,342,145,0,21,0,21,0,21
86000US34234,"34234",21704,1408,10276,765,11428,930,18578,1325,8763,710,9815,890,1458,556,768,301,690,285,981,286,478,181,503,192,502,162,192,97,310,130,185,125,75,70,110,69
86000US34235,"34235",15204,1122,7059,596,8145,685,12823,1118,5978,672,6845,606,1092,384,579,267,513,218,296,137,136,81,160,83,491,227,193,79,298,169,502,270,173,138,329,172
86000US34236,"34236",13182,674,6151,437,7031,442,10275,628,4927,402,5348,415,1484,363,572,206,912,268,630,215,334,175,296,107,673,207,295,112,378,127,120,70,23,22,97,62
86000US34237,"34237",17942,1001,9029,662,8913,626,14332,1071,6806,694,7526,603,2364,425,1450,297,914,214,614,186,393,142,221,108,428,161,237,106,191,95,204,118,143,95,61,39
86000US34238,"34238",19985,839,9305,546,10680,618,16573,826,7678,477,8895,610,1634,414,759,255,875,206,804,318,421,230,383,142,679,209,323,114,356,142,295,157,124,80,171,87
86000US34239,"34239",15569,775,7530,522,8039,484,13243,716,6429,458,6814,461,1308,285,650,202,658,137,441,194,201,99,240,118,442,146,193,95,249,116,135,99,57,44,78,85
86000US34240,"34240",11281,964,5584,500,5697,642,10363,929,5105,524,5258,606,408,193,233,110,175,103,166,147,72,86,94,82,262,142,141,76,121,83,82,86,33,39,49,51
86000US34241,"34241",15462,952,7259,511,8203,624,13927,1026,6452,547,7475,641,1082,444,526,236,556,234,218,160,129,93,89,74,222,121,152,84,70,51,13,21,0,21,13,21
86000US34242,"34242",7465,495,3738,298,3727,273,6295,444,3059,255,3236,247,482,207,289,148,193,75,188,108,111,74,77,58,325,122,194,72,131,59,175,99,85,49,90,54
86000US34243,"34243",31682,1824,14680,1041,17002,1114,26215,1622,12350,933,13865,948,2315,608,845,313,1470,394,1500,363,689,228,811,222,1307,418,690,273,617,236,345,245,106,75,239,206
86000US34251,"34251",7107,1166,4056,815,3051,520,6684,1196,3812,831,2872,525,147,132,69,70,78,73,193,124,116,82,77,58,69,72,45,51,24,36,14,31,14,31,0,19
86000US34266,"34266",32009,522,18501,305,13508,304,27769,939,15951,660,11818,482,1747,465,694,209,1053,331,1651,368,1230,310,421,151,322,132,185,84,137,68,520,433,441,411,79,70
86000US34268,"34268",157,154,69,74,88,85,157,154,69,74,88,85,0,14,0,14,0,14,0,14,0,14,0,14,0,14,0,14,0,14,0,14,0,14,0,14
86000US34269,"34269",4517,470,2188,273,2329,251,3914,435,1889,273,2025,219,95,97,15,15,80,96,267,153,147,92,120,69,241,115,137,79,104,55,0,14,0,14,0,14
86000US34275,"34275",20341,1102,10110,648,10231,631,17538,1308,8650,720,8888,719,900,283,571,193,329,127,273,130,141,81,132,84,1506,474,720,318,786,211,124,89,28,31,96,74
86000US34285,"34285",18653,787,8748,538,9905,552,15291,877,7316,536,7975,547,1370,410,494,161,876,359,404,138,214,95,190,68,1525,354,693,169,832,223,63,48,31,23,32,29
86000US34286,"34286",19890,1876,9165,1183,10725,1305,17704,2205,8263,1306,9441,1385,1627,1220,607,446,1020,843,191,226,108,142,83,100,368,309,187,206,181,197,0,25,0,25,0,25
86000US34287,"34287",28424,1502,12976,796,15448,1051,23884,1452,10883,776,13001,963,2242,593,1077,313,1165,368,888,346,402,170,486,229,1306,412,597,235,709,276,104,70,17,19,87,65
86000US34288,"34288",11418,1457,5724,888,5694,851,10576,1436,5397,863,5179,835,331,310,116,130,215,219,134,162,46,75,88,103,377,265,165,140,212,137,0,21,0,21,0,21
86000US34289,"34289",3481,1177,1441,472,2040,840,2682,1248,1082,484,1600,865,371,472,196,318,175,175,0,14,0,14,0,14,428,554,163,201,265,355,0,14,0,14,0,14
86000US34291,"34291",5560,959,2591,522,2969,578,4972,893,2276,462,2696,555,481,430,271,220,210,253,77,89,22,37,55,65,30,28,22,19,8,14,0,19,0,19,0,19
86000US34292,"34292",15364,847,7197,422,8167,587,13275,842,6323,424,6952,537,1013,360,346,172,667,240,168,110,111,85,57,44,877,277,403,149,474,170,31,33,14,21,17,26
86000US34293,"34293",39413,1267,18874,765,20539,706,33065,1290,15682,734,17383,702,2802,586,1409,341,1393,331,878,325,392,182,486,194,2421,500,1252,292,1169,256,247,129,139,85,108,62
86000US34420,"34420",17605,1428,8849,871,8756,837,15331,1464,7620,920,7711,805,1082,500,499,232,583,325,528,301,329,190,199,165,531,288,309,211,222,126,133,127,92,84,41,49
86000US34428,"34428",8954,1033,4198,593,4756,595,7680,1091,3645,583,4035,640,410,225,157,112,253,142,595,373,260,166,335,238,269,192,136,117,133,97,0,19,0,19,0,19
86000US34429,"34429",8251,851,4100,484,4151,514,7285,872,3611,491,3674,519,519,268,258,153,261,131,138,122,82,76,56,52,309,175,149,98,160,93,0,19,0,19,0,19
86000US34431,"34431",7900,759,4008,462,3892,472,6986,690,3527,395,3459,466,383,187,217,106,166,110,246,154,124,104,122,76,254,160,122,101,132,96,31,48,18,28,13,20
86000US34432,"34432",12641,931,6192,541,6449,495,11081,876,5409,503,5672,472,688,372,370,204,318,181,291,146,168,82,123,74,569,286,233,120,336,184,12,20,12,20,0,21
86000US34433,"34433",6557,830,3086,434,3471,527,5898,811,2804,426,3094,511,29,47,29,47,0,19,223,188,83,88,140,112,368,239,145,123,223,139,39,65,25,42,14,24
86000US34434,"34434",8001,795,3879,472,4122,535,7022,831,3399,451,3623,551,441,247,185,151,256,152,321,182,178,106,143,90,217,126,117,85,100,67,0,19,0,19,0,19
86000US34436,"34436",8115,710,4038,433,4077,401,7149,667,3528,398,3621,374,279,154,138,102,141,66,484,269,264,160,220,131,194,94,99,56,95,52,9,18,9,18,0,19
86000US34442,"34442",14614,846,7382,557,7232,507,13263,839,6767,540,6496,479,599,262,247,121,352,184,209,117,105,67,104,71,543,214,263,119,280,119,0,21,0,21,0,21
86000US34445,"34445",0,14,0,14,0,14,0,14,0,14,0,14,0,14,0,14,0,14,0,14,0,14,0,14,0,14,0,14,0,14,0,14,0,14,0,14
86000US34446,"34446",17409,1114,8356,623,9053,665,15281,995,7459,572,7822,629,873,403,334,226,539,220,632,402,200,92,432,339,590,288,330,185,260,115,33,36,33,36,0,21
86000US34448,"34448",10243,900,5115,498,5128,578,8613,837,4403,492,4210,489,554,251,274,150,280,124,430,254,201,113,229,194,383,255,169,133,214,136,263,390,68,104,195,288
86000US34449,"34449",3183,341,1656,211,1527,200,2815,314,1429,202,1386,179,221,112,146,84,75,59,92,39,44,32,48,28,55,37,37,32,18,19,0,14,0,14,0,14
86000US34450,"34450",10682,816,4731,435,5951,515,8763,816,3997,452,4766,473,888,319,316,130,572,299,691,389,300,180,391,272,330,176,108,70,222,124,10,15,10,15,0,21
86000US34452,"34452",11831,618,5535,382,6296,475,9608,730,4611,438,4997,494,1127,384,412,169,715,321,476,222,255,144,221,122,562,304,229,109,333,211,58,57,28,34,30,32
86000US34453,"34453",10605,863,5270,559,5335,484,9023,850,4574,588,4449,440,624,340,340,239,284,147,453,318,159,167,294,182,472,275,181,138,291,168,33,49,16,26,17,23
86000US34461,"34461",11352,986,5845,704,5507,489,9173,892,4500,617,4673,488,1450,423,971,319,479,181,392,195,187,77,205,182,292,164,142,107,150,80,45,40,45,40,0,21
86000US34465,"34465",17396,1161,8322,861,9074,581,14473,1236,6777,839,7696,626,1620,699,841,381,779,365,760,302,396,176,364,169,496,234,291,173,205,92,47,57,17,27,30,35
86000US34470,"34470",19604,1071,9744,634,9860,652,15883,912,7888,512,7995,610,2527,851,1240,432,1287,473,662,331,391,248,271,150,483,242,199,119,284,139,49,49,26,30,23,27
86000US34471,"34471",25592,1648,11762,928,13830,1024,21888,1606,10036,863,11852,1027,2577,785,1205,376,1372,536,542,303,267,138,275,195,572,259,243,140,329,146,13,14,11,14,2,4
86000US34472,"34472",31000,1748,14726,1030,16274,1137,27653,1677,13073,965,14580,1055,1759,470,903,311,856,239,931,512,400,260,531,303,591,407,284,221,307,195,66,86,66,86,0,29
86000US34473,"34473",19843,2070,9282,1348,10561,1116,17223,1908,8066,1241,9157,1041,715,526,299,231,416,325,677,410,382,247,295,205,1203,663,535,280,668,406,25,37,0,21,25,37
86000US34474,"34474",17028,1478,8017,958,9011,1048,12732,1382,5817,799,6915,957,2492,776,1233,428,1259,415,844,422,558,393,286,111,529,227,183,106,346,180,431,319,226,228,205,149
86000US34475,"34475",13071,1146,6844,697,6227,786,10642,1049,5228,611,5414,786,1413,463,1038,366,375,134,568,164,368,121,200,82,437,331,210,150,227,193,11,22,0,21,11,22
86000US34476,"34476",23140,1145,10213,683,12927,782,20443,1108,9126,638,11317,762,956,480,454,230,502,277,308,168,58,57,250,129,1423,613,565,252,858,389,10,17,10,17,0,25
86000US34479,"34479",13415,915,6048,560,7367,681,11629,1030,5350,629,6279,669,1081,503,438,326,643,325,339,281,131,124,208,173,253,198,129,97,124,109,113,100,0,21,113,100
86000US34480,"34480",18901,1245,9066,794,9835,794,16344,1353,7892,740,8452,872,1700,588,810,372,890,316,312,364,71,83,241,284,545,321,293,231,252,153,0,21,0,21,0,21
86000US34481,"34481",20916,1207,10063,705,10853,728,18925,1192,8854,645,10071,754,740,276,392,153,348,164,463,266,366,241,97,69,725,268,407,162,318,137,63,56,44,37,19,31
86000US34482,"34482",24173,1601,11224,1074,12949,934,19206,1563,9534,1066,9672,834,1340,601,761,416,579,213,2452,466,447,138,2005,425,1057,425,411,190,646,275,118,158,71,96,47,63
86000US34484,"34484",3614,645,1503,320,2111,442,3052,588,1311,301,1741,409,110,110,19,24,91,102,243,208,139,119,104,102,164,163,10,17,154,168,45,50,24,23,21,34
86000US34488,"34488",10197,915,5322,539,4875,532,8468,964,4423,586,4045,508,1303,598,636,295,667,364,319,206,174,103,145,107,89,67,71,56,18,22,18,27,18,27,0,21
86000US34491,"34491",26482,1917,12933,1166,13549,1047,22895,1932,11257,1168,11638,1045,2028,706,905,375,1123,400,740,477,433,288,307,202,703,340,279,150,424,221,116,121,59,72,57,68
86000US34498,"34498",563,120,251,58,312,82,415,88,184,48,231,64,73,63,25,21,48,45,49,37,27,25,22,18,26,24,15,13,11,13,0,14,0,14,0,14
86000US34601,"34601",22199,977,10112,609,12087,650,19646,1140,8989,604,10657,746,1473,416,696,240,777,240,526,261,234,122,292,152,533,200,172,84,361,157,21,32,21,32,0,25
86000US34602,"34602",7684,791,3990,485,3694,429,6572,832,3416,537,3156,392,311,218,144,86,167,151,750,438,412,251,338,195,48,34,15,25,33,31,3,7,3,7,0,19
86000US34604,"34604",12392,698,5872,485,6520,477,10090,732,4702,445,5388,488,910,298,502,179,408,146,988,377,460,214,528,201,383,278,208,145,175,139,21,24,0,21,21,24
86000US34606,"34606",26875,1105,13244,765,13631,645,22896,1105,11083,709,11813,642,1676,455,886,287,790,231,1122,560,598,344,524,237,953,357,560,234,393,143,228,150,117,89,111,72
86000US34607,"34607",8340,504,4071,329,4269,301,6864,556,3372,330,3492,341,468,236,215,110,253,137,460,240,221,117,239,132,523,283,246,121,277,174,25,29,17,18,8,13
86000US34608,"34608",34552,1347,16715,758,17837,880,29930,1316,14356,782,15574,796,2223,525,1099,311,1124,314,1324,510,685,275,639,289,967,342,543,229,424,158,108,78,32,27,76,58
86000US34609,"34609",41913,1024,19739,632,22174,756,35628,1256,16749,697,18879,868,1789,452,806,220,983,300,2660,814,1313,382,1347,502,1436,394,764,233,672,216,400,215,107,97,293,139
86000US34610,"34610",14580,852,7378,528,7202,506,13051,815,6621,528,6430,456,1005,421,557,231,448,210,392,226,128,75,264,187,132,75,72,51,60,54,0,21,0,21,0,21
86000US34613,"34613",17865,910,8570,528,9295,604,16022,896,7698,503,8324,599,491,177,259,111,232,111,325,128,165,94,160,79,1017,362,448,174,569,214,10,16,0,21,10,16
86000US34614,"34614",7109,538,3459,327,3650,369,6544,532,3160,307,3384,370,220,117,136,85,84,58,170,119,106,81,64,56,114,82,48,38,66,55,61,67,9,16,52,60
86000US34637,"34637",8314,560,4794,407,3520,339,5488,589,2894,352,2594,329,1784,310,1274,242,510,182,872,324,556,166,316,200,170,109,70,47,100,76,0,19,0,19,0,19
86000US34638,"34638",28092,998,13464,733,14628,698,24217,1302,11679,842,12538,811,1644,727,686,347,958,428,1497,564,691,295,806,302,578,311,277,160,301,169,156,125,131,111,25,30
86000US34639,"34639",29060,1252,13633,633,15427,869,25724,1090,12053,588,13671,751,1164,341,603,172,561,226,1511,570,608,274,903,323,557,199,319,125,238,102,104,67,50,41,54,43
86000US34652,"34652",23573,970,10972,592,12601,592,20503,857,9419,513,11084,560,1656,358,846,216,810,208,482,163,240,96,242,87,886,202,444,117,442,126,46,31,23,22,23,22
86000US34653,"34653",34156,1362,16390,910,17766,838,28393,1198,13649,721,14744,803,3481,1078,1697,560,1784,561,1089,327,510,170,579,182,936,225,450,112,486,154,257,134,84,64,173,76
86000US34654,"34654",22773,1138,11324,779,11449,628,20161,1203,10002,717,10159,678,1793,486,924,350,869,254,436,342,223,149,213,206,343,163,148,97,195,93,40,67,27,46,13,23
86000US34655,"34655",41620,1256,19629,688,21991,908,36550,1264,17263,688,19287,861,1996,405,915,200,1081,258,1543,429,699,200,844,279,1458,329,731,210,727,171,73,60,21,20,52,48
86000US34661,"34661",104,109,11,17,93,107,63,54,11,17,52,48,0,14,0,14,0,14,41,63,0,14,41,63,0,14,0,14,0,14,0,14,0,14,0,14
86000US34667,"34667",33047,1366,15702,754,17345,840,27735,1289,13226,746,14509,771,2461,596,1048,264,1413,421,1328,438,701,239,627,236,1303,389,633,171,670,259,220,111,94,68,126,62
86000US34668,"34668",47640,1408,23077,902,24563,906,39592,1286,19240,797,20352,840,4215,848,2248,476,1967,461,2042,484,871,242,1171,323,1637,569,680,286,957,356,154,64,38,25,116,50
86000US34669,"34669",13166,748,6601,578,6565,380,11248,755,5530,516,5718,410,862,346,499,238,363,150,520,249,264,156,256,116,520,270,300,173,220,127,16,25,8,12,8,13
86000US34677,"34677",21967,556,10282,478,11685,545,19082,739,9057,526,10025,548,1643,474,708,273,935,298,829,240,385,134,444,176,347,157,118,84,229,99,66,75,14,21,52,70
86000US34679,"34679",43,36,11,17,32,24,43,36,11,17,32,24,0,14,0,14,0,14,0,14,0,14,0,14,0,14,0,14,0,14,0,14,0,14,0,14
86000US34681,"34681",693,380,324,214,369,196,689,379,320,214,369,196,2,4,2,4,0,14,2,5,2,5,0,14,0,14,0,14,0,14,0,14,0,14,0,14
86000US34683,"34683",33224,1347,16119,931,17105,729,28314,1351,13496,808,14818,843,3134,760,1533,438,1601,397,444,232,252,172,192,93,1285,571,811,367,474,231,47,43,27,31,20,32
86000US34684,"34684",28902,1017,13319,709,15583,668,24165,1077,11141,735,13024,626,2691,549,1182,290,1509,356,576,203,248,114,328,146,1342,420,655,236,687,226,128,100,93,85,35,33
86000US34685,"34685",17976,934,8572,556,9404,628,15472,961,7417,550,8055,612,1228,398,584,228,644,240,457,257,196,108,261,159,698,292,322,146,376,200,121,91,53,51,68,60
86000US34688,"34688",7408,669,3634,472,3774,355,6281,648,3166,453,3115,317,627,221,276,109,351,163,130,102,31,26,99,92,282,209,116,72,166,151,88,139,45,72,43,68
86000US34689,"34689",27327,462,12825,562,14502,587,23482,739,11043,567,12439,672,2022,471,1024,270,998,250,830,258,348,154,482,188,744,260,230,90,514,211,249,136,180,126,69,42
86000US34690,"34690",11362,711,5512,407,5850,501,10266,693,4961,393,5305,483,432,166,224,95,208,90,312,122,148,75,164,65,253,140,137,76,116,74,99,69,42,44,57,49
86000US34691,"34691",20145,1103,10161,654,9984,674,18067,1057,8975,611,9092,638,646,224,360,137,286,113,810,237,485,149,325,115,534,224,320,140,214,108,88,67,21,26,67,50
86000US34695,"34695",18156,253,8681,412,9475,438,15969,590,7595,443,8374,526,1606,517,780,261,826,297,318,160,149,101,169,81,203,107,122,89,81,45,60,59,35,45,25,23
86000US34698,"34698",38493,949,17720,740,20773,796,31984,1176,14681,819,17303,756,3829,704,1744,391,2085,425,782,305,371,177,411,184,1773,439,864,233,909,245,125,95,60,53,65,56
86000US34705,"34705",2813,510,1473,295,1340,265,2500,450,1341,269,1159,234,202,131,89,62,113,81,83,53,26,26,57,35,25,24,17,20,8,11,3,5,0,14,3,5
86000US34711,"34711",61072,1652,29126,1070,31946,1256,51165,2202,24197,1210,26968,1474,2811,979,1515,634,1296,434,4562,1249,2259,744,2303,657,2346,863,1046,413,1300,555,188,154,109,87,79,75
86000US34714,"34714",22283,1989,12012,1240,10271,1129,18158,2174,9476,1260,8682,1176,1526,1119,993,825,533,398,1152,507,712,348,440,237,549,282,259,193,290,159,898,827,572,527,326,306
86000US34715,"34715",18113,1009,9006,652,9107,622,14474,1195,6897,671,7577,711,1453,619,664,289,789,362,1620,466,1178,324,442,212,416,426,178,172,238,256,150,165,89,101,61,69
86000US34731,"34731",14739,629,6955,467,7784,437,12127,797,5748,525,6379,466,1067,420,482,206,585,257,861,507,460,338,401,195,647,199,240,76,407,152,37,45,25,29,12,20
86000US34734,"34734",4542,900,1980,366,2562,632,4010,878,1686,358,2324,609,453,280,240,165,213,165,0,14,0,14,0,14,79,76,54,64,25,31,0,14,0,14,0,14
86000US34736,"34736",19004,1168,9910,861,9094,792,16710,1388,8655,935,8055,808,687,350,425,263,262,128,1258,668,715,392,543,340,224,189,94,66,130,173,125,106,21,34,104,98
86000US34737,"34737",2879,439,1431,270,1448,236,2290,399,1122,247,1168,206,363,198,172,94,191,117,168,90,109,65,59,43,52,39,25,20,27,20,6,9,3,5,3,5
86000US34739,"34739",243,159,145,105,98,81,233,147,135,94,98,81,10,17,10,17,0,14,0,14,0,14,0,14,0,14,0,14,0,14,0,14,0,14,0,14
86000US34741,"34741",47036,1964,23948,1271,23088,1301,37882,1934,19280,1335,18602,1144,3924,843,2163,562,1761,416,2782,821,1325,530,1457,415,992,387,535,253,457,192,1456,479,645,312,811,316
86000US34743,"34743",44839,2330,21946,1413,22893,1455,38585,2282,18770,1287,19815,1446,2691,1149,1242,507,1449,688,1581,583,907,411,674,317,728,431,326,185,402,326,1254,583,701,347,553,273
86000US34744,"34744",56606,2968,27205,1625,29401,1857,47177,3104,22729,1647,24448,1883,4459,1304,2319,862,2140,636,1562,541,755,301,807,306,1707,695,748,331,959,455,1701,1220,654,502,1047,1001
86000US34746,"34746",43611,2814,21593,1581,22018,1728,37570,2769,18954,1611,18616,1663,2627,1109,1048,452,1579,804,1162,348,418,165,744,237,1142,522,632,346,510,244,1110,536,541,283,569,285
86000US34747,"34747",21189,1655,10253,928,10936,984,16280,1412,7767,787,8513,823,1093,353,445,175,648,251,1868,473,921,329,947,281,1293,416,765,308,528,196,655,418,355,222,300,209
86000US34748,"34748",39586,1005,18695,675,20891,761,33053,1100,15356,691,17697,804,3276,759,1680,424,1596,425,1674,535,823,296,851,295,1481,386,743,209,738,219,102,65,93,65,9,16
86000US34753,"34753",5845,331,3292,334,2553,308,5209,615,2869,425,2340,357,213,163,124,146,89,68,326,398,253,312,73,91,71,77,46,53,25,36,26,42,0,19,26,42
86000US34756,"34756",3474,473,1716,261,1758,299,3253,480,1578,266,1675,297,121,87,77,64,44,34,74,50,48,39,26,32,21,20,13,17,8,10,5,7,0,14,5,7
86000US34758,"34758",42890,3163,22474,2015,20416,1633,37295,3193,19629,1984,17666,1696,2205,1137,1168,592,1037,586,1676,679,776,346,900,396,789,492,492,338,297,174,925,645,409,291,516,400
86000US34759,"34759",39988,2585,19475,1505,20513,1732,34668,2761,16580,1667,18088,1744,1311,696,566,370,745,389,1930,1138,1227,811,703,396,1585,703,857,430,728,355,494,360,245,203,249,176
86000US34760,"34760",863,197,364,131,499,140,657,182,266,127,391,133,198,146,98,72,100,75,8,13,0,14,8,13,0,14,0,14,0,14,0,14,0,14,0,14
86000US34761,"34761",45272,1234,21987,984,23285,1081,38633,1468,18765,998,19868,1116,3812,818,1900,498,1912,411,1131,357,706,269,425,220,1023,517,468,251,555,339,673,433,148,131,525,334
86000US34762,"34762",544,262,277,139,267,144,515,257,248,130,267,144,29,46,29,46,0,14,0,14,0,14,0,14,0,14,0,14,0,14,0,14,0,14,0,14
86000US34769,"34769",24595,1743,11727,1036,12868,1146,21719,1673,10440,1025,11279,1077,1586,679,688,328,898,395,590,229,181,102,409,183,505,245,332,179,173,92,195,135,86,60,109,88
86000US34771,"34771",20766,1882,10051,1063,10715,991,18376,1871,8922,994,9454,1033,1114,534,570,274,544,315,679,391,363,220,316,220,516,343,181,139,335,230,81,102,15,24,66,80
86000US34772,"34772",30962,1732,14751,1174,16211,1208,28162,1941,13483,1232,14679,1254,1256,536,601,265,655,326,1007,470,490,253,517,282,301,203,112,73,189,143,236,199,65,96,171,169
86000US34773,"34773",3683,863,1710,493,1973,456,2902,900,1443,507,1459,424,265,187,82,96,183,127,154,146,78,80,76,81,362,293,107,105,255,258,0,14,0,14,0,14
86000US34785,"34785",38071,1293,20760,685,17311,841,30771,1302,16409,758,14362,880,2438,461,1550,366,888,196,1108,336,633,220,475,173,3344,501,1842,302,1502,288,410,157,326,140,84,80
86000US34786,"34786",45361,2911,22515,1830,22846,1599,37202,2698,18811,1728,18391,1355,3092,927,1559,430,1533,580,1087,442,394,190,693,303,2366,902,1104,564,1262,468,1614,790,647,357,967,518
86000US34787,"34787",69166,2731,33336,1633,35830,1827,57111,3196,27399,1648,29712,2091,6816,1464,3228,769,3588,858,2195,727,1090,401,1105,417,2051,673,1137,479,914,352,993,660,482,299,511,376
86000US34788,"34788",18066,1037,8543,611,9523,635,14999,1037,7131,590,7868,616,1342,447,681,225,661,276,732,367,296,182,436,227,960,373,416,156,544,242,33,54,19,32,14,23
86000US34797,"34797",1041,301,484,154,557,160,1041,301,484,154,557,160,0,14,0,14,0,14,0,14,0,14,0,14,0,14,0,14,0,14,0,14,0,14,0,14
86000US34945,"34945",5149,547,3044,415,2105,279,4018,497,2177,321,1841,270,786,272,645,239,141,63,250,102,149,58,101,68,85,60,63,44,22,23,10,18,10,18,0,19
86000US34946,"34946",6052,679,3022,404,3030,385,5473,681,2706,392,2767,379,264,116,182,92,82,44,178,99,73,49,105,63,51,35,18,16,33,25,86,58,43,30,43,28
86000US34947,"34947",13859,1454,6687,864,7172,883,12160,1467,5804,848,6356,887,1178,678,613,422,565,288,124,146,34,40,90,108,262,223,151,188,111,78,135,134,85,81,50,61
86000US34949,"34949",7657,581,3618,332,4039,386,7045,568,3292,308,3753,386,50,42,45,41,5,10,256,157,135,95,121,77,240,137,121,90,119,62,66,79,25,38,41,44
86000US34950,"34950",16543,1318,8310,910,8233,820,14207,1346,7061,859,7146,838,1552,614,715,314,837,363,416,224,283,174,133,144,336,197,219,129,117,86,32,32,32,32,0,21
86000US34951,"34951",16934,1147,8002,688,8932,771,15235,1100,7091,648,8144,761,471,237,281,160,190,114,632,300,369,202,263,173,484,186,183,89,301,129,112,120,78,73,34,55
86000US34952,"34952",41211,1953,19518,1038,21693,1220,34188,1832,15974,1003,18214,1124,3064,592,1609,393,1455,308,2451,527,1150,287,1301,346,1311,331,680,244,631,182,197,125,105,89,92,75
86000US34953,"34953",70139,2561,33687,1663,36452,1653,62460,2682,29910,1612,32550,1684,2423,849,1167,574,1256,514,4018,1158,1872,668,2146,710,930,442,560,272,370,253,308,240,178,189,130,124
86000US34956,"34956",10130,431,5934,458,4196,381,8436,619,4772,448,3664,474,663,455,335,241,328,234,910,221,786,195,124,87,46,53,9,14,37,46,75,65,32,33,43,47
86000US34957,"34957",23071,1064,11739,769,11332,594,19907,1035,9937,698,9970,634,941,300,520,181,421,178,686,222,403,158,283,105,1275,380,698,249,577,178,262,185,181,128,81,68
86000US34972,"34972",20631,836,11951,589,8680,498,18815,862,10599,628,8216,477,520,230,399,195,121,90,1077,343,794,245,283,166,201,99,147,82,54,40,18,20,12,17,6,9
86000US34974,"34974",23705,906,11826,542,11879,603,21800,918,10790,561,11010,582,766,289,348,162,418,159,392,165,229,94,163,86,556,224,283,127,273,125,191,102,176,97,15,23
86000US34981,"34981",5330,1211,2796,785,2534,618,4780,1156,2535,756,2245,541,160,157,31,52,129,147,96,72,53,67,43,58,243,213,150,172,93,84,51,77,27,39,24,38
86000US34982,"34982",24953,1488,11971,866,12982,947,21550,1299,10336,789,11214,833,2186,825,1073,461,1113,453,685,385,308,138,377,322,319,182,143,95,176,130,213,279,111,134,102,149
86000US34983,"34983",42451,1830,21008,1167,21443,1226,35773,1775,17642,1089,18131,1178,2528,930,1292,473,1236,530,2896,1101,1452,530,1444,733,1083,433,517,243,566,282,171,252,105,173,66,83
86000US34984,"34984",15939,860,8641,605,7298,519,14277,917,7665,608,6612,527,900,277,575,226,325,144,584,273,293,150,291,155,178,147,108,94,70,56,0,21,0,21,0,21
86000US34986,"34986",28033,2561,12939,1539,15094,1649,24255,2474,11326,1416,12929,1647,960,477,516,369,444,246,1301,732,535,293,766,499,1393,795,438,271,955,680,124,197,124,197,0,25
86000US34987,"34987",9676,1509,4726,816,4950,796,7316,1282,3465,654,3851,735,988,590,604,358,384,265,321,173,173,108,148,89,849,572,461,345,388,261,202,211,23,38,179,201
86000US34990,"34990",29747,1246,14083,802,15664,781,26677,1323,12777,810,13900,802,1561,611,625,261,936,399,934,361,494,217,440,195,508,281,187,102,321,205,67,87,0,25,67,87
86000US34994,"34994",17542,852,8839,583,8703,630,13936,924,6970,593,6966,624,1258,359,654,203,604,236,1569,441,910,320,659,187,720,295,304,175,416,159,59,64,1,2,58,64
86000US34996,"34996",10660,535,5086,371,5574,345,9154,527,4308,368,4846,316,526,177,279,106,247,119,270,126,156,117,114,57,690,295,332,193,358,145,20,32,11,17,9,15
86000US34997,"34997",44427,1328,21615,837,22812,914,38053,1500,18672,897,19381,1000,2287,569,1141,322,1146,345,2081,499,951,281,1130,312,1560,486,642,237,918,304,446,265,209,124,237,172
