geoid,name,B11002001,"B11002001, Error",B11002002,"B11002002, Error",B11002003,"B11002003, Error",B11002004,"B11002004, Error",B11002005,"B11002005, Error",B11002006,"B11002006, Error",B11002007,"B11002007, Error",B11002008,"B11002008, Error",B11002009,"B11002009, Error",B11002010,"B11002010, Error",B11002011,"B11002011, Error",B11002012,"B11002012, Error"
01000US,United States,316606796,0,262918860,128652,190197881,662814,188444918,673028,1752963,16702,20336823,223464,17859150,198246,2477673,28715,52384156,336207,49071638,319374,3312518,22100,53687936,128685
04000US12,Florida,20470021,0,16861757,18847,11627587,57061,11509476,57608,118111,4220,1426240,26614,1255058,23416,171182,5061,3807930,36883,3560817,33951,247113,5327,3608264,18847
86000US32003,"32003",28664,1622,25968,1764,21880,1710,21743,1704,137,108,938,328,867,297,71,69,3150,991,3029,967,121,107,2696,587
86000US32008,"32008",4413,810,3431,766,2452,654,2452,654,0,14,353,253,298,210,55,63,626,326,581,298,45,56,982,266
86000US32009,"32009",3661,287,3274,323,2789,309,2789,309,0,14,185,113,179,111,6,9,300,158,293,151,7,12,387,124
86000US32011,"32011",14509,862,12982,949,9880,996,9875,994,5,8,1092,482,853,343,239,217,2010,497,1898,482,112,62,1527,316
86000US32024,"32024",19447,1118,16260,1107,12321,1259,12163,1247,158,84,1404,653,1321,648,83,66,2535,744,2381,687,154,109,3187,728
86000US32025,"32025",18954,1129,14938,1262,9063,1101,9024,1104,39,44,1690,585,1411,521,279,177,4185,878,3747,763,438,204,4016,431
86000US32026,"32026",0,14,0,14,0,14,0,14,0,14,0,14,0,14,0,14,0,14,0,14,0,14,0,14
86000US32033,"32033",4538,474,3937,514,2539,427,2539,427,0,14,115,113,103,102,12,20,1283,317,1213,302,70,75,601,183
86000US32034,"32034",36087,1200,30279,1550,24218,1713,24192,1710,26,30,2128,668,1840,567,288,194,3933,868,3729,841,204,124,5808,702
86000US32038,"32038",10184,847,8443,916,6438,836,6334,810,104,102,507,297,457,267,50,49,1498,457,1415,442,83,55,1741,342
86000US32040,"32040",7329,935,6665,924,5046,857,5028,853,18,25,383,281,328,229,55,60,1236,412,1072,353,164,134,664,199
86000US32043,"32043",26218,1147,22952,1257,17359,1326,17237,1320,122,93,1289,533,1066,435,223,119,4304,1147,3889,1009,415,222,3266,594
86000US32044,"32044",1711,466,1331,461,870,344,870,344,0,14,99,113,99,113,0,14,362,337,353,337,9,10,380,147
86000US32046,"32046",9161,644,8186,691,6572,673,6462,649,110,63,507,227,497,224,10,17,1107,362,1019,320,88,65,975,183
86000US32052,"32052",6132,752,5232,693,3103,650,3097,648,6,15,761,414,671,367,90,63,1368,359,1299,337,69,55,900,235
86000US32053,"32053",3508,452,3172,453,2562,461,2553,461,9,16,100,70,80,57,20,27,510,210,500,214,10,22,336,126
86000US32054,"32054",8232,633,6963,583,4880,523,4801,522,79,84,277,134,245,125,32,31,1806,462,1775,447,31,37,1269,297
86000US32055,"32055",16194,1089,12909,1095,8196,1186,7953,1134,243,175,1413,495,1270,440,143,85,3300,740,3067,700,233,137,3285,571
86000US32058,"32058",3527,434,3144,426,1925,370,1881,357,44,51,391,198,350,177,41,46,828,311,772,277,56,51,383,136
86000US32059,"32059",2418,444,1976,400,1279,397,1276,397,3,5,374,246,247,160,127,111,323,153,319,152,4,7,442,181
86000US32060,"32060",23197,1008,20898,1035,14315,1416,14202,1399,113,100,2144,778,1912,655,232,183,4439,1193,4017,1057,422,256,2299,443
86000US32061,"32061",514,371,514,371,469,369,469,369,0,14,45,71,45,71,0,14,0,14,0,14,0,14,0,14
86000US32062,"32062",1826,469,1621,490,1017,332,1017,332,0,14,191,231,135,158,56,91,413,309,413,309,0,14,205,118
86000US32063,"32063",12402,825,10858,894,8574,965,8557,966,17,29,875,493,836,467,39,49,1409,588,1347,537,62,120,1544,430
86000US32064,"32064",6473,155,5317,520,2856,770,2815,763,41,47,922,570,922,570,0,19,1539,698,1511,698,28,49,1156,493
86000US32065,"32065",37113,1917,33569,1881,25232,1841,25048,1810,184,171,1875,578,1728,538,147,97,6462,1249,5986,1173,476,211,3544,645
86000US32066,"32066",5911,506,5369,538,4315,725,4201,721,114,86,67,75,62,68,5,11,987,465,955,452,32,61,542,170
86000US32068,"32068",57287,2570,51530,2671,38523,2509,37928,2449,595,409,4911,1746,3914,1129,997,791,8096,1401,7095,1230,1001,331,5757,860
86000US32071,"32071",3869,657,3396,692,2447,534,2447,534,0,14,502,371,429,302,73,78,447,324,422,311,25,39,473,263
86000US32072,"32072",211,148,161,157,74,91,74,91,0,14,0,14,0,14,0,14,87,132,87,132,0,14,50,49
86000US32073,"32073",41929,1414,36664,1544,25494,1675,25339,1661,155,102,3473,940,2868,695,605,422,7697,1321,7354,1285,343,125,5265,548
86000US32079,"32079",336,113,204,86,186,74,186,74,0,14,0,14,0,14,0,14,18,33,18,33,0,14,132,54
86000US32080,"32080",22251,763,17593,875,14806,1020,14697,1019,109,80,796,425,747,411,49,68,1991,493,1844,455,147,99,4658,616
86000US32081,"32081",14856,1436,14136,1491,13361,1479,13309,1476,52,80,214,177,175,141,39,47,561,295,550,296,11,17,720,215
86000US32082,"32082",30493,1109,25336,1074,21551,1056,21500,1057,51,63,1176,461,1105,443,71,45,2609,618,2473,579,136,83,5157,652
86000US32083,"32083",1376,238,1228,230,1051,225,1050,225,1,2,84,67,74,62,10,13,93,63,93,63,0,14,148,63
86000US32084,"32084",34240,1446,26399,1693,17249,1252,16952,1217,297,174,1691,567,1491,527,200,114,7459,1211,6850,1098,609,225,7841,923
86000US32086,"32086",29243,1291,23363,1369,17485,1313,17336,1293,149,101,1679,583,1429,517,250,160,4199,1028,3804,916,395,199,5880,706
86000US32087,"32087",5316,785,4558,795,2948,737,2948,737,0,19,183,249,160,222,23,30,1427,741,1120,500,307,367,758,413
86000US32091,"32091",14779,837,12103,867,8055,1052,8017,1047,38,42,1188,655,1108,636,80,103,2860,628,2683,593,177,97,2676,494
86000US32092,"32092",36930,2215,32876,2234,27204,2071,27013,2084,191,179,921,689,921,689,0,29,4751,1978,4451,1822,300,273,4054,1109
86000US32094,"32094",2283,559,1895,542,1621,521,1575,515,46,71,31,58,31,58,0,14,243,263,243,263,0,14,388,184
86000US32095,"32095",11661,1321,10144,1382,7695,1166,7672,1159,23,39,842,647,783,638,59,65,1607,798,1369,675,238,173,1517,449
86000US32096,"32096",2181,331,1765,327,1233,267,1231,266,2,5,111,102,87,77,24,28,421,194,397,180,24,25,416,99
86000US32097,"32097",18738,935,16623,1050,12256,1160,12127,1149,129,123,1274,456,1044,364,230,137,3093,747,2830,683,263,132,2115,515
86000US32102,"32102",2283,444,1599,477,906,289,906,289,0,14,318,260,301,256,17,21,375,323,375,323,0,14,684,162
86000US32110,"32110",7941,598,6299,598,3814,656,3783,652,31,29,945,478,825,410,120,106,1540,438,1379,389,161,106,1642,292
86000US32112,"32112",7568,756,6109,746,3688,748,3632,734,56,52,1038,454,988,431,50,49,1383,570,1260,518,123,81,1459,255
86000US32113,"32113",4938,767,4232,751,2259,561,2259,561,0,19,1041,629,722,432,319,277,932,519,859,462,73,79,706,240
86000US32114,"32114",30137,1061,19967,1359,7880,1026,7692,989,188,175,2781,786,2548,727,233,118,9306,1181,8863,1146,443,176,10170,1007
86000US32117,"32117",25876,1135,19820,1296,10808,1190,10528,1189,280,256,2274,690,2003,618,271,165,6738,1127,6301,1062,437,174,6056,561
86000US32118,"32118",17515,854,11617,973,8152,794,8152,794,0,21,1573,555,1337,444,236,144,1892,585,1833,575,59,49,5898,488
86000US32119,"32119",22271,564,15858,681,10353,849,10256,849,97,64,1904,524,1732,488,172,86,3601,640,3305,541,296,171,6413,571
86000US32124,"32124",4201,509,3348,540,2704,495,2681,495,23,34,86,71,77,62,9,14,558,302,532,273,26,42,853,181
86000US32127,"32127",30277,1100,23434,1184,17477,1504,17389,1489,88,73,2277,606,1907,494,370,192,3680,993,3425,951,255,123,6843,781
86000US32128,"32128",21174,1000,18612,1146,14390,1200,14285,1203,105,100,1559,708,1451,686,108,104,2663,816,2552,792,111,92,2562,496
86000US32129,"32129",22148,1051,15695,1196,11012,1216,10844,1193,168,136,972,488,828,402,144,142,3711,908,3569,879,142,68,6453,661
86000US32130,"32130",5685,774,5035,804,4003,869,3950,859,53,81,485,390,394,304,91,98,547,422,532,418,15,24,650,175
86000US32131,"32131",3768,420,3058,467,2154,434,2142,435,12,17,376,182,363,179,13,20,528,272,512,270,16,24,710,192
86000US32132,"32132",7565,488,5698,553,3892,521,3862,519,30,28,734,439,551,304,183,169,1072,382,994,345,78,77,1867,220
86000US32133,"32133",17,38,17,38,17,38,17,38,0,14,0,14,0,14,0,14,0,14,0,14,0,14,0,14
86000US32134,"32134",7745,846,6265,834,4949,814,4803,776,146,87,396,250,367,230,29,39,920,320,853,307,67,46,1480,332
86000US32136,"32136",8306,312,6510,366,5695,373,5695,373,0,19,371,210,352,205,19,16,444,210,424,197,20,24,1796,270
86000US32137,"32137",43783,1120,36942,1218,29035,1325,28660,1311,375,193,2399,639,2151,590,248,175,5508,1000,5069,895,439,240,6841,694
86000US32139,"32139",971,333,785,339,599,328,599,328,0,14,33,56,20,34,13,23,153,151,153,151,0,14,186,70
86000US32140,"32140",1439,390,1224,409,523,257,509,249,14,23,133,209,133,209,0,14,568,347,445,280,123,114,215,115
86000US32141,"32141",19017,674,15502,710,11242,901,11096,863,146,141,1252,586,1053,477,199,126,3008,625,2686,538,322,149,3515,488
86000US32145,"32145",5520,472,4449,522,3070,423,2968,409,102,104,265,175,214,143,51,56,1114,434,944,362,170,118,1071,304
86000US32147,"32147",790,633,790,633,287,376,287,376,0,14,199,163,164,131,35,54,304,431,150,207,154,226,0,14
86000US32148,"32148",10710,1021,8748,1053,5114,874,5027,853,87,75,1259,584,962,406,297,266,2375,725,2093,624,282,219,1962,379
86000US32157,"32157",363,206,315,214,122,96,122,96,0,14,36,37,36,37,0,14,157,182,157,182,0,14,48,38
86000US32159,"32159",29777,947,22365,991,17616,1150,17489,1159,127,125,1219,550,1029,460,190,133,3530,747,3290,713,240,111,7412,611
86000US32162,"32162",54908,2012,44190,2154,41849,2092,41787,2108,62,131,760,559,721,527,39,63,1581,837,1581,837,0,32,10718,1095
86000US32164,"32164",47232,1027,40698,1331,27494,1725,27162,1696,332,184,3505,1098,2929,901,576,265,9699,1224,8715,1095,984,297,6534,764
86000US32168,"32168",27630,1081,21679,1134,16661,1074,16627,1064,34,40,1727,554,1464,459,263,141,3291,753,3060,692,231,146,5951,772
86000US32169,"32169",10047,743,6922,610,5625,590,5610,580,15,25,503,237,420,184,83,67,794,258,758,253,36,33,3125,431
86000US32174,"32174",50593,1160,39678,1585,30878,1663,30730,1635,148,125,2838,798,2453,667,385,179,5962,977,5641,931,321,164,10915,1045
86000US32176,"32176",14450,753,10630,818,8134,729,8060,742,74,78,732,339,719,336,13,21,1764,378,1703,366,61,46,3820,356
86000US32177,"32177",26174,1096,21485,1142,13456,1218,13380,1228,76,69,1225,516,1069,452,156,96,6804,1080,6208,966,596,255,4689,537
86000US32179,"32179",7909,1101,6160,1087,3657,618,3657,618,0,19,350,175,350,175,0,19,2153,913,2035,886,118,91,1749,397
86000US32180,"32180",4535,684,3999,693,3072,648,2987,656,85,54,470,273,413,255,57,48,457,299,422,258,35,48,536,177
86000US32181,"32181",2523,538,1918,530,1399,508,1370,492,29,34,141,106,125,87,16,27,378,249,367,247,11,14,605,165
86000US32187,"32187",1863,422,1627,470,1312,425,1297,419,15,23,0,14,0,14,0,14,315,278,315,278,0,14,236,148
86000US32189,"32189",5874,810,4539,859,3396,760,3388,760,8,11,342,237,313,225,29,34,801,561,767,518,34,53,1335,319
86000US32190,"32190",1309,512,1203,531,1063,541,1063,541,0,14,66,92,66,92,0,14,74,113,74,113,0,14,106,82
86000US32193,"32193",705,233,537,232,415,221,402,211,13,21,0,14,0,14,0,14,122,77,122,77,0,14,168,71
86000US32195,"32195",2926,581,2494,547,1763,523,1652,480,111,88,169,135,154,121,15,23,562,395,562,395,0,14,432,153
86000US32202,"32202",3108,388,1513,397,688,300,688,300,0,19,52,61,52,61,0,19,773,264,693,234,80,64,1595,222
86000US32204,"32204",7154,770,3356,664,2175,534,2149,521,26,45,124,124,96,89,28,46,1057,417,1014,400,43,45,3798,503
86000US32205,"32205",30169,1355,21963,1416,12927,1332,12815,1327,112,86,2228,611,1891,505,337,166,6808,1012,6452,955,356,141,8206,609
86000US32206,"32206",15629,868,11263,916,3702,609,3694,611,8,12,1457,435,1373,420,84,55,6104,793,5852,748,252,99,4366,439
86000US32207,"32207",35127,1417,26332,1625,18027,1495,17853,1491,174,155,2009,935,1936,909,73,69,6296,1173,5992,1086,304,147,8795,817
86000US32208,"32208",30727,1638,25128,1778,11020,1327,10976,1336,44,53,3535,910,3286,871,249,125,10573,1539,10240,1517,333,141,5599,592
86000US32209,"32209",34449,1522,27671,1641,7032,916,6899,917,133,203,3816,841,3503,766,313,137,16823,1431,15938,1339,885,259,6778,562
86000US32210,"32210",61892,1870,50657,2225,29123,1931,28840,1931,283,121,5549,858,4687,729,862,249,15985,1927,15015,1835,970,220,11235,1025
86000US32211,"32211",35358,1523,28593,1754,16522,1338,16155,1312,367,226,2678,800,2265,672,413,202,9393,1176,8647,1043,746,311,6765,714
86000US32212,"32212",907,121,892,124,798,196,798,196,0,14,0,14,0,14,0,14,94,114,94,114,0,14,15,18
86000US32216,"32216",37108,1760,28438,1898,17959,1764,17868,1771,91,77,2722,839,2105,616,617,274,7757,1159,7233,1137,524,179,8670,746
86000US32217,"32217",19625,1029,14896,1190,9913,996,9897,992,16,26,2071,687,1813,590,258,176,2912,817,2841,799,71,53,4729,623
86000US32218,"32218",63113,2499,54414,2661,33480,2723,33279,2753,201,119,3262,759,2917,672,345,200,17672,2348,16493,2202,1179,424,8699,908
86000US32219,"32219",12502,1684,10624,1711,8048,1925,7960,1941,88,116,613,333,586,323,27,35,1963,880,1897,862,66,70,1878,420
86000US32220,"32220",12979,1123,11424,1175,8216,1078,8200,1074,16,24,853,507,769,451,84,98,2355,817,2330,811,25,40,1555,320
86000US32221,"32221",30693,1565,27365,1644,19311,1626,19138,1593,173,102,2693,900,2316,762,377,210,5361,1276,4891,1152,470,245,3328,668
86000US32222,"32222",11521,1256,10585,1303,7644,1017,7600,1015,44,55,539,396,426,318,113,91,2402,743,2294,754,108,104,936,262
86000US32223,"32223",24506,753,21247,865,16562,1019,16413,1019,149,104,1410,484,1250,430,160,118,3275,690,3040,617,235,134,3259,355
86000US32224,"32224",39875,2118,30775,2373,23491,2226,23267,2168,224,184,1670,918,1529,781,141,173,5614,1419,5103,1288,511,241,9100,1010
86000US32225,"32225",55018,1816,47093,2008,34876,1877,34322,1814,554,255,3141,901,2829,835,312,146,9076,1424,8579,1339,497,200,7925,805
86000US32226,"32226",15633,970,14134,960,11815,1156,11700,1154,115,87,395,319,303,231,92,101,1924,595,1739,560,185,131,1499,293
86000US32227,"32227",1693,255,1689,256,1572,248,1572,248,0,14,53,59,53,59,0,14,64,56,64,56,0,14,4,6
86000US32228,"32228",0,14,0,14,0,14,0,14,0,14,0,14,0,14,0,14,0,14,0,14,0,14,0,14
86000US32233,"32233",22998,668,17522,815,11233,784,11167,783,66,46,1216,430,1131,412,85,62,5073,721,4629,650,444,218,5476,592
86000US32234,"32234",5867,672,5063,656,3941,722,3881,710,60,47,188,117,165,99,23,22,934,377,885,355,49,50,804,223
86000US32244,"32244",59220,2370,50209,2700,30258,2266,29744,2255,514,307,4156,1113,3634,953,522,297,15795,1911,14643,1774,1152,373,9011,1120
86000US32246,"32246",51406,2392,40090,2578,27197,2140,26924,2131,273,148,3420,1102,2892,878,528,296,9473,1432,8855,1291,618,256,11316,1216
86000US32250,"32250",27071,574,19795,834,15570,876,15462,873,108,81,541,274,469,239,72,74,3684,880,3366,803,318,230,7276,678
86000US32254,"32254",13102,899,10571,896,4493,734,4442,736,51,50,961,328,940,322,21,25,5117,863,4923,832,194,98,2531,492
86000US32256,"32256",47818,2146,34892,2465,25835,2249,25740,2244,95,113,2537,780,2390,772,147,142,6520,1341,6022,1157,498,328,12926,1165
86000US32257,"32257",38622,1152,31775,1194,24544,1397,24424,1400,120,81,2596,781,2100,594,496,286,4635,1084,4271,1008,364,194,6847,600
86000US32258,"32258",33853,1986,29245,2067,21941,1934,21603,1899,338,217,2771,1112,2430,957,341,255,4533,1485,4051,1286,482,449,4608,750
86000US32259,"32259",52278,1384,49427,1431,42693,1318,42459,1308,234,126,1486,456,1394,439,92,64,5248,1200,4993,1140,255,150,2851,477
86000US32266,"32266",7101,329,5152,438,4238,438,4238,438,0,19,274,190,236,162,38,61,640,285,550,233,90,88,1949,394
86000US32277,"32277",31327,1550,25788,1672,16065,1482,15966,1489,99,89,1998,772,1807,726,191,104,7725,1233,7311,1131,414,205,5539,597
86000US32301,"32301",28282,910,17627,1080,8416,953,8342,934,74,71,2171,573,1971,536,200,109,7040,725,6741,692,299,111,10655,913
86000US32303,"32303",48411,1654,32925,1700,20483,1377,20361,1333,122,124,3078,719,2683,620,395,161,9364,1233,8886,1179,478,196,15486,1137
86000US32304,"32304",41718,1598,12200,1188,3884,721,3861,717,23,25,1214,437,969,336,245,140,7102,1192,6562,1118,540,208,29518,1578
86000US32305,"32305",20435,1171,17080,1350,8144,1013,8073,996,71,65,2008,734,1859,673,149,93,6928,1122,6408,1034,520,204,3355,604
86000US32308,"32308",21143,1061,14948,1059,11493,1007,11425,1032,68,82,687,381,687,381,0,25,2768,725,2718,711,50,44,6195,605
86000US32309,"32309",31574,1207,27299,1376,22355,1431,22274,1420,81,59,786,332,687,275,99,88,4158,743,3932,684,226,158,4275,534
86000US32310,"32310",14846,1169,11503,1142,5963,878,5958,878,5,8,1130,458,1000,411,130,91,4410,895,4060,826,350,176,3343,454
86000US32311,"32311",21323,867,17990,972,12556,927,12450,908,106,92,758,330,639,274,119,118,4676,926,4473,904,203,139,3333,481
86000US32312,"32312",32750,1227,29243,1225,24940,1330,24898,1331,42,34,1177,401,1139,398,38,27,3126,742,2999,691,127,101,3507,632
86000US32317,"32317",14773,925,13209,936,11369,791,11296,787,73,60,225,122,204,110,21,22,1615,728,1527,662,88,96,1564,292
86000US32320,"32320",3867,369,3251,394,2292,388,2292,388,0,14,261,203,217,172,44,43,698,226,645,206,53,57,616,142
86000US32321,"32321",4876,358,4221,389,2424,438,2410,437,14,17,768,380,739,370,29,40,1029,310,1017,308,12,21,655,167
86000US32322,"32322",2472,271,1922,262,1227,294,1222,294,5,8,188,151,168,131,20,23,507,276,472,271,35,37,550,133
86000US32323,"32323",137,83,90,86,90,86,90,86,0,14,0,14,0,14,0,14,0,14,0,14,0,14,47,52
86000US32324,"32324",3663,465,2880,424,1549,355,1549,355,0,14,166,139,166,139,0,14,1165,351,1158,350,7,10,783,190
86000US32327,"32327",25084,676,21839,729,17384,1163,17313,1153,71,63,1682,556,1514,492,168,115,2773,752,2406,662,367,178,3245,483
86000US32328,"32328",3334,398,2776,392,2005,407,2005,407,0,14,174,147,174,147,0,14,597,258,545,225,52,52,558,158
86000US32330,"32330",651,239,600,236,312,174,302,166,10,16,88,88,82,84,6,10,200,119,200,119,0,14,51,44
86000US32331,"32331",4058,486,3557,511,2044,464,2000,454,44,39,394,199,326,162,68,51,1119,385,1111,382,8,13,501,151
86000US32332,"32332",1077,315,860,320,362,200,362,200,0,14,86,111,86,111,0,14,412,228,412,228,0,14,217,87
86000US32333,"32333",10874,905,8749,952,5331,697,5319,694,12,20,735,459,404,232,331,274,2683,630,2643,623,40,42,2125,406
86000US32334,"32334",2024,303,1680,306,977,259,977,259,0,14,595,143,572,139,23,25,108,84,91,71,17,30,344,105
86000US32336,"32336",1128,306,985,312,823,297,818,297,5,11,13,22,13,22,0,14,149,130,121,108,28,40,143,75
86000US32340,"32340",9377,704,7632,791,4811,781,4811,781,0,21,447,263,399,232,48,41,2374,507,2266,482,108,57,1745,277
86000US32343,"32343",3221,21,2819,139,1857,238,1839,237,18,30,267,192,237,175,30,41,695,252,635,232,60,54,402,137
86000US32344,"32344",10276,435,8291,429,6036,571,6012,578,24,26,571,202,418,141,153,105,1684,382,1591,367,93,62,1985,277
86000US32346,"32346",1933,431,1536,456,1133,481,1133,481,0,14,0,14,0,14,0,14,403,376,403,376,0,14,397,138
86000US32347,"32347",7454,508,6441,601,5453,616,5178,567,275,183,208,179,208,179,0,19,780,404,710,359,70,64,1013,321
86000US32348,"32348",9282,597,7991,652,4926,676,4926,676,0,21,283,239,166,135,117,107,2782,585,2710,556,72,85,1291,272
86000US32350,"32350",1272,318,903,261,753,249,753,249,0,14,90,95,90,95,0,14,60,94,51,77,9,18,369,158
86000US32351,"32351",16412,942,14135,898,7145,899,7105,884,40,60,525,310,471,271,54,68,6465,913,6223,879,242,144,2277,379
86000US32352,"32352",6246,901,5459,953,3747,750,3670,729,77,111,120,146,96,109,24,42,1592,590,1447,562,145,115,787,242
86000US32355,"32355",244,89,182,72,134,61,129,58,5,9,41,45,39,44,2,4,7,11,7,11,0,14,62,40
86000US32356,"32356",0,14,0,14,0,14,0,14,0,14,0,14,0,14,0,14,0,14,0,14,0,14,0,14
86000US32358,"32358",2021,507,1668,503,1071,389,1071,389,0,14,17,15,17,15,0,14,580,305,562,297,18,28,353,124
86000US32359,"32359",1271,392,1072,397,962,376,962,376,0,14,0,14,0,14,0,14,110,103,110,103,0,14,199,102
86000US32361,"32361",383,190,345,205,263,165,263,165,0,14,82,120,82,120,0,14,0,14,0,14,0,14,38,48
86000US32399,"32399",0,14,0,14,0,14,0,14,0,14,0,14,0,14,0,14,0,14,0,14,0,14,0,14
86000US32401,"32401",21590,1168,16386,1227,7068,761,6979,747,89,83,2257,829,1837,666,420,207,7061,929,6768,864,293,158,5204,516
86000US32403,"32403",2399,308,2355,308,2267,315,2267,315,0,14,33,41,33,41,0,14,55,74,55,74,0,14,44,27
86000US32404,"32404",38752,1500,32937,1565,23122,1663,23015,1649,107,86,2852,658,2497,545,355,229,6963,1220,6424,1173,539,226,5815,615
86000US32405,"32405",31773,1291,25939,1287,16855,1256,16627,1219,228,128,2296,678,2077,597,219,122,6788,995,6407,928,381,165,5834,628
86000US32407,"32407",10708,692,7953,724,6103,698,6036,688,67,70,511,271,448,250,63,46,1339,394,1218,368,121,90,2755,451
86000US32408,"32408",18850,919,14473,990,10558,1108,10497,1107,61,54,1038,474,854,405,184,170,2877,810,2618,757,259,153,4377,618
86000US32409,"32409",10144,879,8996,867,7128,838,7079,828,49,75,697,464,672,461,25,38,1171,455,1106,420,65,72,1148,232
86000US32410,"32410",964,134,754,135,648,134,648,134,0,14,16,24,16,24,0,14,90,51,77,44,13,13,210,60
86000US32413,"32413",14805,905,12001,905,9806,1081,9694,1057,112,103,722,330,665,315,57,48,1473,444,1326,390,147,89,2804,428
86000US32420,"32420",1958,318,1526,301,1069,302,1044,292,25,41,100,77,90,69,10,11,357,155,341,149,16,14,432,124
86000US32421,"32421",4834,583,4094,575,3068,525,3068,525,0,14,487,304,434,270,53,51,539,229,498,200,41,39,740,239
86000US32423,"32423",966,232,884,241,732,246,732,246,0,14,33,32,33,32,0,14,119,80,119,80,0,14,82,39
86000US32424,"32424",5495,517,4440,511,3095,512,3095,512,0,19,244,197,232,189,12,21,1101,342,1073,335,28,27,1055,197
86000US32425,"32425",11814,577,10029,619,7073,631,7050,633,23,21,674,277,619,264,55,44,2282,640,2140,576,142,105,1785,285
86000US32426,"32426",814,170,743,170,423,118,422,117,1,3,48,50,48,50,0,14,272,145,247,123,25,31,71,36
86000US32427,"32427",1007,234,684,217,499,187,484,178,15,18,35,44,34,44,1,2,150,112,149,112,1,3,323,120
86000US32428,"32428",14746,666,12425,733,8559,820,8472,818,87,51,1146,438,1036,390,110,79,2720,536,2602,503,118,75,2321,342
86000US32430,"32430",1173,363,947,353,727,313,727,313,0,14,69,116,69,116,0,14,151,157,131,129,20,34,226,100
86000US32431,"32431",4145,395,3555,405,2591,366,2544,367,47,50,236,128,229,125,7,9,728,249,698,237,30,40,590,114
86000US32432,"32432",0,14,0,14,0,14,0,14,0,14,0,14,0,14,0,14,0,14,0,14,0,14,0,14
86000US32433,"32433",16405,1084,14059,1190,9827,1101,9523,1035,304,344,750,422,621,341,129,112,3482,1027,3065,908,417,256,2346,435
86000US32435,"32435",7262,684,5646,781,4310,689,4251,698,59,79,285,180,215,131,70,61,1051,514,1042,513,9,14,1616,406
86000US32437,"32437",843,275,734,274,318,135,318,135,0,14,308,201,308,201,0,14,108,78,106,78,2,4,109,50
86000US32438,"32438",3803,676,2810,671,1819,558,1792,550,27,43,162,126,162,126,0,14,829,479,706,414,123,117,993,333
86000US32439,"32439",10413,919,8883,982,6661,809,6617,805,44,45,830,569,763,510,67,68,1392,477,1273,454,119,59,1530,274
86000US32440,"32440",5286,508,4480,491,3131,419,3111,417,20,20,607,287,536,258,71,52,742,230,646,196,96,76,806,190
86000US32442,"32442",3299,555,2584,585,2028,574,2028,574,0,14,165,121,161,119,4,7,391,215,391,215,0,14,715,203
86000US32443,"32443",3165,416,2831,439,1880,374,1871,376,9,15,170,127,135,96,35,34,781,320,709,279,72,84,334,90
86000US32444,"32444",22142,948,19657,943,15032,1214,14887,1210,145,101,1013,341,892,290,121,86,3612,890,3535,872,77,65,2485,441
86000US32445,"32445",1224,212,995,220,730,210,730,210,0,14,114,92,105,83,9,13,151,88,144,86,7,9,229,73
86000US32446,"32446",9651,781,8017,875,5947,702,5941,705,6,26,182,150,143,112,39,45,1888,601,1791,560,97,80,1634,312
86000US32447,"32447",0,14,0,14,0,14,0,14,0,14,0,14,0,14,0,14,0,14,0,14,0,14,0,14
86000US32448,"32448",8290,693,6523,694,3968,606,3968,606,0,19,956,652,731,502,225,199,1599,516,1559,503,40,45,1767,330
86000US32449,"32449",552,205,536,210,441,231,441,231,0,14,56,92,56,92,0,14,39,63,39,63,0,14,16,17
86000US32455,"32455",4048,499,3598,493,2834,492,2834,492,0,14,89,72,86,70,3,8,675,230,563,181,112,102,450,145
86000US32456,"32456",7883,395,6848,397,5243,523,5233,520,10,16,451,213,367,171,84,73,1154,411,1105,402,49,38,1035,187
86000US32459,"32459",17126,1050,13698,1092,10881,1153,10845,1148,36,39,937,363,859,344,78,69,1880,663,1769,653,111,108,3428,693
86000US32460,"32460",3482,410,2885,471,1640,365,1609,353,31,52,529,222,425,192,104,69,716,283,642,250,74,59,597,165
86000US32461,"32461",36,40,22,33,22,33,22,33,0,14,0,14,0,14,0,14,0,14,0,14,0,14,14,21
86000US32462,"32462",3420,404,2844,385,1788,404,1754,393,34,30,430,223,341,177,89,74,626,242,596,231,30,30,576,158
86000US32463,"32463",216,99,154,97,91,70,91,70,0,14,40,46,40,46,0,14,23,37,23,37,0,14,62,36
86000US32464,"32464",4367,499,3688,495,2352,530,2352,530,0,14,574,259,493,228,81,72,762,325,717,304,45,45,679,164
86000US32465,"32465",5674,422,4488,446,3227,557,3212,556,15,19,272,172,249,153,23,30,989,348,927,335,62,45,1186,309
86000US32466,"32466",5795,1116,5050,1134,4070,949,3928,907,142,136,426,450,410,427,16,24,554,425,541,416,13,22,745,249
86000US32501,"32501",9699,747,7207,739,3180,567,3150,556,30,45,922,481,879,475,43,48,3105,762,2990,710,115,86,2492,304
86000US32502,"32502",3258,457,2179,474,1342,376,1342,376,0,14,118,120,118,120,0,14,719,341,687,324,32,34,1079,211
86000US32503,"32503",29536,1262,22454,1451,14254,1253,14180,1252,74,71,1298,480,1073,361,225,213,6902,995,6590,940,312,197,7082,728
86000US32504,"32504",22384,1248,17942,1399,11763,1324,11580,1319,183,162,1358,652,1168,559,190,161,4821,1157,4549,1060,272,199,4442,547
86000US32505,"32505",26088,1606,19409,1887,10061,1665,9996,1658,65,67,2234,923,2107,854,127,99,7114,1048,6785,989,329,138,6679,745
86000US32506,"32506",36378,1756,29172,1900,18899,1619,18749,1613,150,87,2758,656,2333,592,425,154,7515,1287,7211,1242,304,133,7206,696
86000US32507,"32507",30602,1537,22943,1704,14830,1526,14766,1526,64,59,1828,574,1577,490,251,124,6285,1209,5919,1137,366,171,7659,802
86000US32508,"32508",1205,181,815,168,785,173,785,173,0,19,0,19,0,19,0,19,30,36,30,36,0,19,390,113
86000US32509,"32509",0,14,0,14,0,14,0,14,0,14,0,14,0,14,0,14,0,14,0,14,0,14,0,14
86000US32511,"32511",0,14,0,14,0,14,0,14,0,14,0,14,0,14,0,14,0,14,0,14,0,14,0,14
86000US32514,"32514",40051,1634,29917,1695,19024,1636,18788,1596,236,160,2203,666,1957,585,246,144,8690,1373,8042,1284,648,267,10134,821
86000US32526,"32526",37194,1263,31197,1444,22809,1277,22379,1198,430,248,2565,962,2348,836,217,159,5823,992,5634,971,189,69,5997,715
86000US32530,"32530",40,67,40,67,40,67,40,67,0,14,0,14,0,14,0,14,0,14,0,14,0,14,0,14
86000US32531,"32531",5517,796,4484,824,3538,767,3538,767,0,19,78,105,58,79,20,38,868,576,868,576,0,19,1033,324
86000US32533,"32533",29498,1279,25624,1434,19967,1470,19888,1468,79,67,1282,523,1148,461,134,129,4375,908,4256,875,119,94,3874,515
86000US32534,"32534",14702,1134,11164,1174,6433,844,6433,844,0,21,1446,708,1260,628,186,143,3285,837,3096,765,189,205,3538,483
86000US32535,"32535",4419,556,3749,589,2070,406,2070,406,0,19,599,297,525,267,74,73,1080,370,994,332,86,86,670,152
86000US32536,"32536",24029,1257,21125,1358,17193,1370,17072,1379,121,150,711,452,591,381,120,90,3221,874,2971,797,250,177,2904,559
86000US32539,"32539",27436,1502,24448,1719,17153,1776,17035,1774,118,106,2643,1035,2039,794,604,315,4652,1278,4257,1131,395,253,2988,539
86000US32541,"32541",18917,514,14117,563,11440,661,11256,643,184,117,789,266,714,243,75,54,1888,412,1783,394,105,68,4800,478
86000US32542,"32542",2069,438,1838,434,1595,483,1595,483,0,14,0,14,0,14,0,14,243,181,243,181,0,14,231,78
86000US32544,"32544",1100,396,1100,396,1047,392,1047,392,0,14,0,14,0,14,0,14,53,84,53,84,0,14,0,14
86000US32547,"32547",34008,1329,25014,1467,17148,1265,16782,1261,366,227,2327,714,2039,630,288,162,5539,949,5166,906,373,160,8994,718
86000US32548,"32548",21468,763,16017,937,10602,1011,10538,1003,64,47,1561,405,1347,348,214,98,3854,633,3686,607,168,85,5451,496
86000US32550,"32550",7912,769,6639,786,5466,708,5373,712,93,69,534,395,467,346,67,81,639,283,596,252,43,69,1273,293
86000US32561,"32561",9877,366,8182,535,6595,597,6577,595,18,29,559,408,543,403,16,25,1028,361,996,349,32,37,1695,435
86000US32563,"32563",25715,1124,22235,1233,18392,1131,18300,1130,92,71,1193,461,969,358,224,127,2650,596,2477,541,173,97,3480,458
86000US32564,"32564",2922,819,2651,857,2394,903,2380,902,14,23,127,117,127,117,0,14,130,155,130,155,0,14,271,156
86000US32565,"32565",4916,364,4122,382,3315,391,3271,384,44,42,271,183,240,157,31,39,536,202,515,197,21,30,794,184
86000US32566,"32566",40201,1454,35714,1551,29523,1635,29381,1614,142,108,1676,706,1568,668,108,136,4515,815,4149,743,366,186,4487,1040
86000US32567,"32567",3099,494,2592,482,1876,433,1853,430,23,18,151,112,151,112,0,14,565,196,540,191,25,26,507,104
86000US32568,"32568",2853,478,2601,468,2036,469,2021,466,15,22,452,250,423,247,29,29,113,92,113,92,0,14,252,98
86000US32569,"32569",12637,754,10008,736,7824,812,7663,795,161,136,827,414,730,359,97,101,1357,465,1230,417,127,97,2629,492
86000US32570,"32570",30966,1211,26019,1339,18570,1510,18312,1498,258,154,1350,505,1234,457,116,82,6099,961,5675,856,424,191,4947,666
86000US32571,"32571",35497,1289,32069,1439,25188,1425,24926,1409,262,158,2595,1016,2084,782,511,349,4286,1106,3822,922,464,361,3428,533
86000US32577,"32577",4390,636,3814,682,3201,619,3192,620,9,14,90,65,82,57,8,12,523,286,517,284,6,9,576,151
86000US32578,"32578",33098,847,29408,975,25167,1065,24869,1047,298,174,1244,438,1193,425,51,47,2997,586,2813,544,184,110,3690,468
86000US32579,"32579",10338,587,8376,662,6398,676,6262,618,136,121,639,272,529,223,110,84,1339,353,1257,320,82,59,1962,266
86000US32580,"32580",4304,245,3721,304,2252,559,2252,559,0,14,459,388,421,371,38,45,1010,554,879,461,131,144,583,233
86000US32583,"32583",23942,1067,20407,1335,15119,1369,15021,1370,98,122,1579,661,1498,653,81,75,3709,980,3344,895,365,155,3535,735
86000US32601,"32601",17864,1275,7265,1196,3725,676,3725,676,0,21,706,361,684,350,22,34,2834,1138,2678,1097,156,131,10599,992
86000US32603,"32603",3630,600,1314,375,952,305,910,286,42,68,123,141,123,141,0,19,239,182,239,182,0,19,2316,545
86000US32605,"32605",25394,1328,19234,1526,14386,1155,14338,1143,48,60,1059,415,974,380,85,77,3789,976,3575,914,214,131,6160,726
86000US32606,"32606",23328,1418,18235,1525,15067,1569,15030,1562,37,59,926,568,886,551,40,50,2242,668,2000,520,242,235,5093,968
86000US32607,"32607",29993,1677,17006,1368,10788,994,10642,985,146,104,964,553,860,453,104,115,5254,1067,5008,1041,246,141,12987,1311
86000US32608,"32608",48964,2067,30012,1953,20738,1801,20617,1784,121,106,2357,938,2199,900,158,97,6917,1372,6362,1271,555,250,18952,1197
86000US32609,"32609",17945,1184,12919,1335,7818,1170,7783,1180,35,54,864,423,788,408,76,49,4237,985,4159,969,78,65,5026,690
86000US32612,"32612",5,7,0,19,0,19,0,19,0,19,0,19,0,19,0,19,0,19,0,19,0,19,5,7
86000US32615,"32615",13611,786,11422,847,8836,923,8820,927,16,24,873,461,771,414,102,83,1713,600,1684,583,29,37,2189,416
86000US32616,"32616",1226,439,1123,473,912,482,912,482,0,14,60,94,30,49,30,46,151,152,151,152,0,14,103,100
86000US32617,"32617",4541,647,3874,638,2707,487,2691,480,16,25,416,332,379,298,37,62,751,354,716,340,35,42,667,205
86000US32618,"32618",8264,1376,7100,1439,4234,825,4113,785,121,139,1122,929,976,743,146,200,1744,681,1640,640,104,77,1164,221
86000US32619,"32619",5630,637,4891,681,3382,694,3312,660,70,69,171,101,158,98,13,19,1338,649,1149,544,189,126,739,198
86000US32621,"32621",4814,675,3849,755,2734,688,2666,683,68,103,257,164,217,139,40,35,858,433,782,413,76,60,965,300
86000US32622,"32622",1032,327,769,252,608,219,608,219,0,14,128,92,126,90,2,3,33,31,33,31,0,14,263,205
86000US32625,"32625",1668,253,1311,230,932,209,932,209,0,14,128,131,99,93,29,45,251,171,224,140,27,40,357,155
86000US32626,"32626",8761,721,7137,790,4798,747,4722,724,76,74,398,221,353,192,45,51,1941,423,1753,360,188,113,1624,287
86000US32628,"32628",3802,452,3186,499,2252,504,2251,503,1,2,128,117,96,87,32,40,806,293,706,233,100,97,616,205
86000US32631,"32631",155,98,89,74,89,74,89,74,0,14,0,14,0,14,0,14,0,14,0,14,0,14,66,71
86000US32639,"32639",194,123,131,132,131,132,131,132,0,14,0,14,0,14,0,14,0,14,0,14,0,14,63,60
86000US32640,"32640",11299,1169,9281,1213,6269,980,6241,981,28,36,792,333,677,273,115,78,2220,767,1994,705,226,124,2018,437
86000US32641,"32641",14333,1078,11649,996,4513,788,4283,702,230,244,1604,585,1568,583,36,35,5532,876,5355,834,177,137,2684,542
86000US32643,"32643",11638,841,9977,895,7579,871,7496,870,83,70,599,419,573,411,26,34,1799,467,1649,421,150,95,1661,306
86000US32648,"32648",392,206,381,206,345,194,345,194,0,14,36,59,21,35,15,25,0,14,0,14,0,14,11,11
86000US32653,"32653",14022,1013,11310,1128,8923,890,8923,890,0,21,492,275,492,275,0,21,1895,744,1820,742,75,61,2712,404
86000US32656,"32656",15150,1049,13060,1085,9912,1120,9835,1090,77,98,769,352,680,309,89,88,2379,633,2232,577,147,99,2090,410
86000US32658,"32658",375,148,329,133,144,94,144,94,0,14,60,66,57,65,3,5,125,94,125,94,0,14,46,66
86000US32664,"32664",391,126,270,117,204,102,204,102,0,14,0,14,0,14,0,14,66,66,66,66,0,14,121,62
86000US32666,"32666",6664,967,5219,971,4031,912,3988,908,43,48,507,336,435,292,72,87,681,385,595,335,86,63,1445,339
86000US32667,"32667",4347,596,3375,636,2504,506,2501,506,3,7,247,148,222,128,25,25,624,354,579,338,45,43,972,207
86000US32668,"32668",4678,719,3847,718,2952,600,2952,600,0,14,337,359,312,320,25,41,558,393,488,333,70,100,831,309
86000US32669,"32669",14027,1021,12286,1067,9867,1107,9784,1093,83,61,634,406,593,402,41,50,1785,666,1743,663,42,32,1741,369
86000US32680,"32680",10134,520,8320,610,5806,605,5791,607,15,24,974,429,809,367,165,102,1540,528,1422,466,118,96,1814,443
86000US32681,"32681",31,47,31,47,31,47,31,47,0,14,0,14,0,14,0,14,0,14,0,14,0,14,0,14
86000US32683,"32683",268,170,253,170,165,200,165,200,0,14,88,140,51,80,37,60,0,14,0,14,0,14,15,15
86000US32686,"32686",4702,667,3764,697,2760,580,2760,580,0,14,436,310,368,254,68,95,568,283,557,282,11,14,938,263
86000US32692,"32692",160,164,147,163,147,163,147,163,0,14,0,14,0,14,0,14,0,14,0,14,0,14,13,23
86000US32693,"32693",10553,818,8648,788,5794,689,5740,665,54,54,1068,382,1009,364,59,63,1786,525,1597,475,189,113,1905,300
86000US32694,"32694",2023,454,1649,481,951,408,951,408,0,14,321,175,289,151,32,37,377,261,365,256,12,14,374,116
86000US32696,"32696",12287,1020,10285,1066,7671,1103,7601,1105,70,89,487,279,455,267,32,35,2127,417,2041,404,86,57,2002,358
86000US32697,"32697",253,100,213,95,188,92,188,92,0,14,12,20,12,20,0,14,13,15,13,15,0,14,40,31
86000US32701,"32701",22664,1018,16834,1187,11002,1216,10942,1205,60,45,1416,582,1296,512,120,97,4416,894,4224,869,192,83,5830,621
86000US32702,"32702",2726,408,2250,382,1347,282,1347,282,0,14,320,157,301,149,19,23,583,298,553,290,30,29,476,167
86000US32703,"32703",53296,2499,45401,2673,29228,2063,28962,2078,266,147,4050,943,3441,807,609,252,12123,2081,11468,1967,655,280,7895,824
86000US32707,"32707",35958,1133,28658,1331,20943,1098,20766,1088,177,119,2113,627,1905,575,208,98,5602,836,5215,786,387,161,7300,742
86000US32708,"32708",45196,865,38884,1183,30192,1668,30080,1672,112,112,2278,692,2019,582,259,168,6414,1207,6091,1142,323,180,6312,824
86000US32709,"32709",1832,429,1654,437,1225,349,1225,349,0,14,0,14,0,14,0,14,429,310,364,263,65,83,178,104
86000US32712,"32712",48115,2068,43358,2151,33480,2149,32864,2089,616,413,3098,1042,2656,825,442,299,6780,1605,6308,1509,472,198,4757,646
86000US32713,"32713",20780,138,16893,630,13767,901,13620,880,147,119,857,509,695,406,162,137,2269,607,2215,572,54,73,3887,646
86000US32714,"32714",37824,1306,29707,1469,18898,1376,18769,1355,129,99,3408,961,3055,849,353,157,7401,1103,6756,971,645,258,8117,785
86000US32720,"32720",30881,1544,24980,1623,16656,1374,16544,1375,112,100,1879,732,1714,675,165,105,6445,1216,6063,1174,382,261,5901,704
86000US32724,"32724",35750,1304,28443,1364,20469,1293,20075,1238,394,165,2043,733,1780,664,263,119,5931,1153,5471,1040,460,232,7307,683
86000US32725,"32725",49593,1428,43473,1617,31048,2004,30713,1954,335,248,4533,1115,4022,973,511,202,7892,1206,7433,1171,459,187,6120,691
86000US32726,"32726",22157,648,18526,841,12571,1086,12499,1083,72,68,1279,523,1188,466,91,79,4676,918,4435,878,241,118,3631,510
86000US32730,"32730",5859,819,4238,960,2969,851,2952,843,17,31,900,532,849,511,51,69,369,289,251,182,118,114,1621,429
86000US32732,"32732",4576,626,4052,673,3519,585,3519,585,0,14,388,409,321,323,67,92,145,143,127,123,18,31,524,195
86000US32735,"32735",4728,629,3957,672,3105,702,3105,702,0,14,0,14,0,14,0,14,852,461,789,407,63,77,771,203
86000US32736,"32736",10831,986,9888,1045,8765,1034,8680,1038,85,79,637,307,556,277,81,67,486,200,441,178,45,48,943,204
86000US32738,"32738",45561,1161,40881,1323,28419,2061,28308,2061,111,69,4633,1158,4030,995,603,248,7829,1335,7427,1284,402,156,4680,669
86000US32744,"32744",3807,455,3188,497,2313,544,2310,543,3,14,146,104,136,99,10,13,729,219,609,168,120,91,619,187
86000US32746,"32746",45013,1216,38692,1479,31022,1426,30898,1413,124,88,1926,608,1705,510,221,151,5744,1093,5454,1027,290,141,6321,801
86000US32750,"32750",24680,744,21031,827,15921,959,15879,953,42,39,1100,374,990,334,110,60,4010,636,3588,583,422,164,3649,428
86000US32751,"32751",22231,1167,18887,1317,13762,1178,13622,1197,140,73,1229,537,1110,477,119,98,3896,827,3803,828,93,51,3344,458
86000US32754,"32754",10984,871,9500,909,7123,926,7080,913,43,46,574,293,562,285,12,20,1803,702,1635,659,168,112,1484,269
86000US32757,"32757",27620,1481,22886,1566,16924,1643,16779,1596,145,188,1493,558,1354,523,139,95,4469,1072,4227,1000,242,175,4734,609
86000US32759,"32759",3014,564,2541,563,1796,436,1768,434,28,26,258,204,227,181,31,28,487,376,422,335,65,90,473,138
86000US32763,"32763",22971,1074,18735,987,13261,1261,13041,1229,220,167,1550,592,1222,429,328,219,3924,955,3707,918,217,121,4236,539
86000US32764,"32764",3165,353,2850,360,1892,358,1849,348,43,37,566,235,514,226,52,37,392,213,382,211,10,11,315,116
86000US32765,"32765",63402,1470,52493,1448,41897,1719,41455,1717,442,210,2913,696,2565,589,348,174,7683,1243,7357,1199,326,179,10909,878
86000US32766,"32766",16788,789,16197,790,14003,1056,13897,1043,106,77,864,334,805,318,59,41,1330,479,1284,467,46,38,591,201
86000US32767,"32767",3329,702,2821,724,1733,468,1733,468,0,14,215,276,215,276,0,14,873,555,765,468,108,139,508,208
86000US32771,"32771",55930,1996,46542,2202,32367,2248,31927,2126,440,561,2379,741,2075,693,304,123,11796,1725,11356,1646,440,203,9388,1042
86000US32773,"32773",30296,1256,25542,1453,16207,1270,16089,1264,118,77,2335,796,1968,661,367,224,7000,1468,6557,1341,443,214,4754,618
86000US32776,"32776",12029,1430,10414,1488,7330,1253,7281,1259,49,83,1563,978,1251,727,312,275,1521,630,1440,597,81,105,1615,502
86000US32778,"32778",21540,697,17363,794,12933,898,12835,912,98,94,852,338,717,288,135,80,3578,619,3406,593,172,99,4177,503
86000US32779,"32779",29514,895,26280,999,21900,1165,21800,1158,100,61,1185,370,1061,317,124,70,3195,694,2870,624,325,118,3234,351
86000US32780,"32780",35944,1060,28232,1332,20843,1436,20536,1517,307,269,1935,608,1718,519,217,123,5454,895,5094,812,360,234,7712,692
86000US32784,"32784",12346,1112,11089,1110,8132,1040,8085,1030,47,52,591,304,534,257,57,71,2366,831,1996,739,370,237,1257,358
86000US32789,"32789",24912,849,19276,1007,15472,1078,15418,1078,54,33,1151,407,941,302,210,139,2653,585,2511,559,142,82,5636,527
86000US32792,"32792",51091,1713,35239,1594,22200,1706,22084,1718,116,90,4231,1005,3375,803,856,338,8808,1345,8352,1222,456,219,15852,1098
86000US32796,"32796",20215,1031,16596,1074,11369,1016,11251,1023,118,101,1349,566,1194,520,155,94,3878,973,3788,955,90,73,3619,469
86000US32798,"32798",2882,560,2258,582,1857,518,1857,518,0,14,252,265,197,203,55,72,149,196,149,196,0,14,624,173
86000US32801,"32801",11721,947,4371,761,3129,628,3107,627,22,34,210,239,169,188,41,64,1032,497,1017,484,15,23,7350,622
86000US32803,"32803",20093,1223,11391,1105,8881,1007,8680,949,201,170,467,214,396,190,71,45,2043,518,1847,466,196,101,8702,841
86000US32804,"32804",17404,985,11968,917,9110,899,9029,893,81,93,730,309,630,271,100,112,2128,463,1996,435,132,90,5436,798
86000US32805,"32805",18162,1244,13158,1271,4826,905,4718,880,108,99,1148,448,1033,390,115,103,7184,1069,6863,1020,321,154,5004,598
86000US32806,"32806",26892,1300,20275,1162,14587,1091,14512,1068,75,59,2227,677,1991,600,236,109,3461,651,3129,583,332,144,6617,644
86000US32807,"32807",34552,1796,28102,1835,14804,1567,14519,1517,285,156,3431,976,2756,759,675,342,9867,1621,8845,1417,1022,374,6450,807
86000US32808,"32808",58878,1997,50640,2404,23725,2559,23425,2473,300,257,5005,1232,4299,1088,706,319,21910,2182,20383,2023,1527,456,8238,839
86000US32809,"32809",29090,1467,23676,1450,13995,1434,13703,1367,292,182,2687,856,2114,588,573,343,6994,1407,6442,1304,552,211,5414,723
86000US32810,"32810",37571,1971,31088,2247,15878,1910,15843,1907,35,36,4330,1581,3689,1287,641,342,10880,1705,10241,1622,639,212,6483,819
86000US32811,"32811",40888,2137,31807,2134,12743,1650,12567,1604,176,161,4002,895,3249,788,753,229,15062,1984,14427,1907,635,216,9081,866
86000US32812,"32812",35779,1425,27637,1492,19603,1238,19434,1231,169,121,2365,676,2084,607,281,158,5669,1076,5502,1041,167,100,8142,800
86000US32814,"32814",7961,1173,5791,1184,5016,1099,4927,1078,89,102,394,499,361,489,33,51,381,352,381,352,0,19,2170,468
86000US32817,"32817",33988,1440,25310,1591,18732,1389,18426,1380,306,146,2697,717,2196,580,501,259,3881,973,3675,943,206,117,8678,1030
86000US32818,"32818",58058,2257,53020,2411,28631,2320,28044,2303,587,307,6083,1632,5282,1411,801,377,18306,2086,17157,1998,1149,467,5038,664
86000US32819,"32819",27220,1185,22802,1257,16335,1153,16191,1155,144,100,1722,597,1543,508,179,112,4745,948,4436,921,309,187,4418,758
86000US32820,"32820",10442,1101,9774,1177,6911,795,6887,792,24,39,732,427,642,393,90,63,2131,1060,1711,740,420,483,668,288
86000US32821,"32821",17617,1494,11699,1336,7904,1216,7661,1149,243,179,872,401,798,377,74,52,2923,843,2663,798,260,149,5918,702
86000US32822,"32822",61642,2809,49390,2813,24851,2174,24448,2138,403,177,6241,1254,5552,1105,689,203,18298,2029,17305,1912,993,275,12252,921
86000US32824,"32824",46473,2879,41781,2893,32140,2747,31764,2701,376,262,3004,1262,2636,1194,368,228,6637,2138,5884,1938,753,425,4692,1115
86000US32825,"32825",61152,2398,51241,2286,33162,2276,32726,2194,436,248,3954,985,3465,928,489,191,14125,2305,13236,2206,889,307,9911,1187
86000US32826,"32826",20960,1118,14300,954,9730,929,9463,905,267,223,1375,517,1123,406,252,168,3195,775,2865,691,330,193,6660,1029
86000US32827,"32827",9427,817,8379,808,6737,784,6718,781,19,32,271,229,271,229,0,19,1371,541,1219,478,152,135,1048,310
86000US32828,"32828",69497,2784,60680,3152,45251,2924,44404,2834,847,501,6298,2295,5330,1882,968,593,9131,2411,8583,2274,548,311,8817,1558
86000US32829,"32829",20376,1832,18432,1869,15128,1818,14956,1811,172,178,944,496,773,406,171,114,2360,1094,2312,1088,48,51,1944,593
86000US32830,"32830",6,10,0,14,0,14,0,14,0,14,0,14,0,14,0,14,0,14,0,14,0,14,6,10
86000US32831,"32831",27,24,0,14,0,14,0,14,0,14,0,14,0,14,0,14,0,14,0,14,0,14,27,24
86000US32832,"32832",27902,2003,24545,2020,19334,2150,19150,2146,184,191,2170,1274,1928,1140,242,224,3041,1388,2951,1360,90,87,3357,695
86000US32833,"32833",9857,901,8863,999,6345,1169,6286,1164,59,68,356,292,356,292,0,19,2162,941,1814,828,348,195,994,332
86000US32835,"32835",47995,2142,39106,2140,24677,2362,24377,2351,300,191,5233,1381,4768,1302,465,234,9196,1708,8750,1687,446,201,8889,1140
86000US32836,"32836",20030,1571,16841,1680,14879,1530,14854,1529,25,39,1137,870,1049,832,88,107,825,433,803,423,22,33,3189,699
86000US32837,"32837",51097,2389,44829,2439,33575,2026,33223,2028,352,237,3423,1117,2985,1000,438,190,7831,1460,7170,1337,661,319,6268,1001
86000US32839,"32839",49643,2466,40022,2915,20654,2517,20406,2503,248,223,4444,1277,4046,1188,398,198,14924,2145,13964,2013,960,328,9621,963
86000US32901,"32901",22778,1042,15151,1060,8701,831,8672,831,29,34,1395,422,1245,393,150,81,5055,1039,4602,918,453,234,7627,656
86000US32903,"32903",14557,726,11599,758,9157,682,9077,676,80,74,1123,575,1000,494,123,102,1319,437,1166,377,153,116,2958,386
86000US32904,"32904",31776,1066,25372,1226,18757,1704,18532,1693,225,164,1558,691,1367,561,191,194,5057,1419,4357,1103,700,441,6404,1006
86000US32905,"32905",23067,1185,17154,1358,10602,1397,10548,1387,54,51,1660,651,1471,595,189,147,4892,1086,4533,1014,359,199,5913,590
86000US32907,"32907",44827,1277,39771,1502,27558,1863,27370,1862,188,136,3260,1115,2866,879,394,289,8953,1724,8214,1618,739,254,5056,558
86000US32908,"32908",13375,1461,12190,1536,7647,1376,7611,1369,36,60,2007,980,1888,894,119,124,2536,1143,2204,881,332,362,1185,547
86000US32909,"32909",31184,1269,26537,1404,18850,1471,18773,1461,77,79,1669,862,1187,494,482,516,6018,1239,5580,1123,438,220,4647,670
86000US32920,"32920",10283,105,7127,445,4516,579,4493,577,23,40,738,328,579,239,159,117,1873,581,1627,426,246,289,3156,420
86000US32922,"32922",16673,1377,12989,1521,6333,1305,6333,1305,0,21,1641,612,1331,513,310,174,5015,1148,4735,1063,280,180,3684,627
86000US32925,"32925",1352,174,1249,195,1101,181,1094,182,7,10,53,77,53,77,0,14,95,52,92,50,3,8,103,42
86000US32926,"32926",21213,1619,17830,1657,13028,1485,12870,1461,158,137,1562,862,1503,842,59,69,3240,876,2996,804,244,128,3383,482
86000US32927,"32927",27120,1273,22646,1626,17186,1444,17005,1424,181,135,2081,779,1800,632,281,201,3379,856,3086,770,293,155,4474,814
86000US32931,"32931",13765,331,9803,473,8324,569,8192,582,132,128,641,285,631,281,10,16,838,359,838,359,0,21,3962,339
86000US32934,"32934",18943,938,16198,981,12677,1068,12583,1032,94,84,1100,550,901,439,199,149,2421,729,2247,687,174,127,2745,284
86000US32935,"32935",41167,1288,31249,1408,19865,1275,19539,1292,326,179,2943,797,2453,626,490,216,8441,1320,7698,1186,743,252,9918,831
86000US32937,"32937",27516,752,22936,858,18732,953,18534,930,198,138,1100,368,1057,369,43,37,3104,641,2970,612,134,87,4580,535
86000US32940,"32940",41907,1861,35354,1871,28542,2073,28366,2037,176,129,1447,697,1248,620,199,142,5365,1442,5024,1350,341,330,6553,934
86000US32948,"32948",7456,773,6806,905,4624,1108,4624,1108,0,19,429,431,393,402,36,51,1753,867,1719,858,34,41,650,354
86000US32949,"32949",2468,311,2194,339,1897,388,1897,388,0,14,175,217,83,90,92,131,122,81,116,78,6,9,274,123
86000US32950,"32950",4522,303,3781,352,3468,367,3414,360,54,50,262,175,244,165,18,26,51,47,40,38,11,11,741,180
86000US32951,"32951",11974,642,10104,681,8735,726,8658,724,77,76,446,274,427,262,19,21,923,344,844,302,79,73,1870,272
86000US32952,"32952",20891,843,17220,899,13684,1073,13623,1075,61,74,1749,830,1586,710,163,137,1787,529,1684,500,103,70,3671,404
86000US32953,"32953",23600,1173,19155,1196,13811,964,13707,972,104,104,1099,451,930,364,169,148,4245,849,3867,787,378,176,4445,516
86000US32955,"32955",38625,1313,33034,1409,26730,1608,26543,1601,187,154,1544,564,1460,527,84,65,4760,1103,4162,952,598,337,5591,625
86000US32958,"32958",28481,574,23311,847,19257,1068,18990,1060,267,219,1104,541,1055,508,49,48,2950,842,2759,792,191,175,5170,647
86000US32960,"32960",21190,989,15170,1046,9172,1092,9143,1093,29,45,1429,752,1063,525,366,286,4569,1084,4167,945,402,220,6020,581
86000US32962,"32962",26409,2179,21767,2254,15215,1995,14862,1902,353,349,907,555,816,526,91,87,5645,1575,4623,1247,1022,473,4642,649
86000US32963,"32963",15022,842,12470,837,11886,801,11742,789,144,96,59,54,59,54,0,21,525,258,523,258,2,5,2552,296
86000US32966,"32966",18323,1346,14059,1238,11197,1114,11106,1080,91,115,591,347,543,320,48,68,2271,723,2195,689,76,78,4264,581
86000US32967,"32967",22267,1418,18813,1499,12570,1328,12459,1310,111,119,2687,836,2525,799,162,191,3556,980,3538,978,18,27,3454,610
86000US32968,"32968",12856,1063,11097,1063,9660,1075,9499,1061,161,133,375,237,331,213,44,40,1062,458,1005,443,57,43,1759,520
86000US32970,"32970",369,293,309,291,138,203,138,203,0,14,0,14,0,14,0,14,171,218,171,218,0,14,60,75
86000US32976,"32976",9092,690,6504,833,4843,679,4813,669,30,33,334,248,296,217,38,47,1327,574,1226,499,101,113,2588,441
86000US33001,"33001",331,124,224,112,194,107,194,107,0,14,4,10,4,10,0,14,26,30,26,30,0,14,107,71
86000US33004,"33004",15923,850,12104,1039,6806,838,6704,838,102,136,1453,633,1374,607,79,80,3845,1011,3568,899,277,183,3819,564
86000US33009,"33009",41515,417,30504,862,17292,1342,17219,1333,73,68,3203,972,3089,933,114,87,10009,1238,9593,1175,416,212,11011,862
86000US33010,"33010",44298,1358,37880,1478,21088,1484,20675,1428,413,174,5262,1082,4565,928,697,263,11530,1396,10683,1264,847,281,6418,534
86000US33012,"33012",73332,1887,64966,2112,38964,2228,38534,2167,430,192,7810,1398,6873,1291,937,300,18192,1620,17119,1546,1073,346,8366,623
86000US33013,"33013",31277,1410,27617,1556,14776,1314,14520,1324,256,137,4495,939,4017,869,478,194,8346,1242,7703,1217,643,205,3660,461
86000US33014,"33014",41788,1603,35853,1760,23364,1592,23251,1590,113,84,3974,1180,3433,1012,541,263,8515,1240,8126,1173,389,181,5935,619
86000US33015,"33015",67041,2098,60254,2336,37274,2401,36799,2386,475,236,4976,1270,4393,1143,583,186,18004,2053,16964,1968,1040,366,6787,848
86000US33016,"33016",51387,1766,47308,1990,29215,2207,29019,2199,196,116,4493,1189,3827,1044,666,295,13600,1553,12477,1433,1123,276,4079,571
86000US33018,"33018",53284,1845,49951,1907,35860,2248,35247,2200,613,293,4160,966,3605,861,555,167,9931,1406,9254,1331,677,199,3333,731
86000US33019,"33019",13686,822,10621,785,8679,769,8582,761,97,76,642,339,594,319,48,37,1300,442,1223,428,77,65,3065,330
86000US33020,"33020",44315,1486,32357,1856,17763,1825,17565,1830,198,130,4060,845,3616,753,444,175,10534,1453,9860,1357,674,189,11958,1034
86000US33021,"33021",49276,1533,41708,1733,26815,1740,26709,1720,106,91,4248,1009,3268,796,980,414,10645,1517,9807,1438,838,256,7568,729
86000US33023,"33023",73662,1921,67141,2148,37347,2569,36825,2558,522,215,7484,1175,6647,1037,837,315,22310,2074,20215,1876,2095,453,6521,735
86000US33024,"33024",76379,2093,68178,2336,42116,2521,41614,2548,502,238,7499,1433,6509,1241,990,379,18563,2098,17900,2044,663,250,8201,903
86000US33025,"33025",72775,2592,58331,3078,33338,2644,32996,2654,342,216,5406,1370,4756,1255,650,249,19587,2057,18514,2009,1073,488,14444,1488
86000US33026,"33026",31881,1081,28225,1220,19832,1203,19597,1198,235,105,2157,545,1879,471,278,139,6236,1351,5755,1227,481,226,3656,389
86000US33027,"33027",60667,2911,52522,3218,38195,3332,38148,3335,47,60,5544,2084,5288,2068,256,158,8783,1716,8208,1585,575,303,8145,1255
86000US33028,"33028",26848,1199,25309,1264,19988,1279,19826,1249,162,115,1820,635,1655,578,165,86,3501,875,3180,811,321,180,1539,303
86000US33029,"33029",48148,2922,46606,2964,35606,2707,35403,2737,203,183,3299,1617,2851,1363,448,374,7701,2150,7397,2137,304,164,1542,414
86000US33030,"33030",34864,1930,32283,2076,17052,2223,16735,2196,317,222,6043,1368,5084,1141,959,379,9188,1677,8228,1623,960,417,2581,787
86000US33031,"33031",7124,1159,6575,1236,4265,1020,4214,1016,51,84,1148,652,1023,589,125,124,1162,687,1100,677,62,59,549,298
86000US33032,"33032",50041,2525,46514,2638,25462,2118,24998,2043,464,266,5440,1702,4675,1456,765,354,15612,2049,14414,1926,1198,343,3527,694
86000US33033,"33033",57979,2425,53898,2586,30958,2606,30659,2570,299,192,6109,1461,5300,1210,809,386,16831,2102,15958,2015,873,212,4081,696
86000US33034,"33034",19114,936,17924,951,7758,1184,7697,1186,61,62,2530,879,2250,812,280,134,7636,1457,6830,1299,806,319,1190,363
86000US33035,"33035",16055,1448,15162,1541,8279,1310,8279,1310,0,21,1874,1175,1478,934,396,266,5009,1311,4720,1233,289,201,893,395
86000US33036,"33036",3456,336,2621,326,2077,299,1975,272,102,63,194,169,156,128,38,56,350,241,288,184,62,83,835,176
86000US33037,"33037",10663,647,8371,692,6747,661,6621,640,126,92,490,257,459,245,31,38,1134,330,944,262,190,140,2292,318
86000US33039,"33039",280,216,185,197,75,66,75,66,0,14,110,183,90,150,20,33,0,14,0,14,0,14,95,114
86000US33040,"33040",33203,757,24151,967,17224,1130,16944,1122,280,171,2262,679,1847,553,415,185,4665,798,3982,602,683,342,9052,816
86000US33042,"33042",6623,423,5285,450,4464,486,4402,467,62,46,365,260,333,228,32,43,456,265,394,228,62,47,1338,246
86000US33043,"33043",4850,443,3548,459,2455,374,2403,373,52,38,504,331,487,326,17,25,589,359,562,350,27,26,1302,265
86000US33050,"33050",9224,107,6816,369,4374,457,4353,458,21,31,854,359,709,284,145,90,1588,466,1415,410,173,111,2408,364
86000US33051,"33051",534,123,344,114,344,114,344,114,0,14,0,14,0,14,0,14,0,14,0,14,0,14,190,78
86000US33054,"33054",30665,1322,27200,1431,10543,1240,10491,1231,52,61,3766,935,3493,896,273,127,12891,1404,12294,1389,597,264,3465,588
86000US33055,"33055",40714,1896,37026,2091,21131,1694,20612,1643,519,209,3715,1159,3222,1039,493,198,12180,1705,11526,1592,654,331,3688,789
86000US33056,"33056",35690,1451,32921,1465,12725,1442,12624,1432,101,80,2966,863,2780,820,186,91,17230,1637,16515,1543,715,235,2769,359
86000US33060,"33060",36860,1490,29413,1775,16858,1633,16825,1635,33,38,3615,1136,3373,1065,242,141,8940,1266,8448,1222,492,207,7447,844
86000US33062,"33062",22513,961,15117,1005,13026,924,12865,908,161,134,914,378,811,323,103,77,1177,279,1106,255,71,62,7396,672
86000US33063,"33063",54478,1399,42595,1458,26940,1996,26498,1960,442,216,3322,820,2847,681,475,230,12333,1541,11705,1446,628,223,11883,901
86000US33064,"33064",60250,1744,49238,2159,28751,2274,28048,2206,703,396,5437,1451,4487,1261,950,310,15050,2367,13952,2210,1098,354,11012,1238
86000US33065,"33065",57947,1562,52118,1841,33253,2257,33003,2237,250,153,4631,1126,4136,991,495,237,14234,1738,13162,1649,1072,486,5829,766
86000US33066,"33066",16739,761,11468,868,8005,968,7895,960,110,112,1214,542,1055,468,159,137,2249,750,2156,707,93,82,5271,639
86000US33067,"33067",27332,1397,24967,1457,19398,1530,19343,1523,55,50,1701,812,1631,797,70,72,3868,1168,3669,1097,199,120,2365,419
86000US33068,"33068",52657,1440,45100,1645,25065,1725,24770,1735,295,173,5299,1316,4645,1160,654,257,14736,1754,13722,1691,1014,279,7557,865
86000US33069,"33069",24742,1155,18442,1297,11066,1256,10752,1202,314,169,1710,532,1590,514,120,63,5666,882,5371,839,295,143,6300,691
86000US33070,"33070",4991,518,3979,518,3475,511,3425,498,50,51,178,148,161,136,17,20,326,187,326,187,0,19,1012,259
86000US33071,"33071",39371,1253,35834,1347,25236,1467,24977,1420,259,147,2893,811,2381,655,512,202,7705,1315,7205,1243,500,237,3537,468
86000US33073,"33073",35130,994,30480,1138,21985,1385,21756,1384,229,200,2439,809,2093,707,346,183,6056,1231,5514,1101,542,243,4650,798
86000US33076,"33076",39091,1085,37095,1161,31415,1508,31287,1517,128,93,1209,528,1053,438,156,131,4471,1388,3958,1207,513,411,1996,398
86000US33101,"33101",0,14,0,14,0,14,0,14,0,14,0,14,0,14,0,14,0,14,0,14,0,14,0,14
86000US33109,"33109",408,179,314,172,314,172,314,172,0,14,0,14,0,14,0,14,0,14,0,14,0,14,94,77
86000US33122,"33122",205,102,148,111,148,111,148,111,0,14,0,14,0,14,0,14,0,14,0,14,0,14,57,48
86000US33125,"33125",58865,2270,47991,2688,26250,2348,25718,2371,532,229,7345,1472,6318,1241,1027,367,14396,1806,13699,1762,697,223,10874,1069
86000US33126,"33126",52756,2019,44802,2267,24508,1950,23725,1890,783,321,7257,1416,6527,1326,730,242,13037,1453,12059,1303,978,286,7954,1136
86000US33127,"33127",30813,1844,25979,1926,12833,1902,12549,1881,284,134,2041,676,1835,588,206,122,11105,1539,10866,1517,239,116,4834,577
86000US33128,"33128",7381,892,5425,916,2595,710,2584,708,11,17,614,324,589,306,25,47,2216,682,2067,619,149,105,1956,389
86000US33129,"33129",13695,1637,9034,1337,6741,1151,6678,1138,63,73,390,274,352,253,38,45,1903,836,1691,699,212,257,4661,953
86000US33130,"33130",29550,1958,20015,1947,12001,1757,11865,1761,136,203,2219,650,2082,617,137,115,5795,1440,5672,1426,123,107,9535,1086
86000US33131,"33131",18477,1302,10530,1367,8278,1157,8260,1159,18,28,760,415,698,393,62,58,1492,565,1474,559,18,21,7947,828
86000US33132,"33132",11853,901,6241,877,5104,744,5091,740,13,23,442,202,416,199,26,33,695,365,669,355,26,42,5612,586
86000US33133,"33133",35459,1966,28578,2121,19381,1633,19128,1616,253,146,3673,1557,3097,1309,576,316,5524,976,5194,931,330,147,6881,619
86000US33134,"33134",40146,1845,32213,1870,22861,1805,22440,1787,421,261,2051,634,1869,581,182,128,7301,1318,6771,1194,530,244,7933,774
86000US33135,"33135",38655,1720,31105,1950,17117,1718,16995,1724,122,96,4825,1052,4531,966,294,174,9163,1329,8826,1266,337,167,7550,854
86000US33136,"33136",14253,1020,9921,1041,4262,887,4262,887,0,21,1407,457,1226,376,181,130,4252,895,4148,874,104,81,4332,498
86000US33137,"33137",22291,1275,14216,1266,7663,907,7643,906,20,25,1867,698,1706,664,161,101,4686,939,4427,889,259,134,8075,667
86000US33138,"33138",30129,1743,22817,2130,15156,1657,15087,1644,69,70,1921,726,1868,716,53,57,5740,1337,5460,1213,280,237,7312,917
86000US33139,"33139",38873,1221,22284,1412,15868,1306,15673,1290,195,143,2588,784,2245,678,343,167,3828,887,3476,783,352,170,16589,960
86000US33140,"33140",19612,1054,15035,1001,11777,898,11648,875,129,89,1418,346,1293,322,125,69,1840,516,1735,487,105,85,4577,490
86000US33141,"33141",39553,1256,27959,1386,18235,1585,17837,1530,398,346,3249,872,2788,773,461,200,6475,1190,6186,1150,289,137,11594,1037
86000US33142,"33142",58047,2224,48777,2489,21424,1979,21142,1972,282,156,6927,1319,5979,1136,948,380,20426,1781,19604,1702,822,262,9270,823
86000US33143,"33143",30885,1240,23744,1388,16511,1306,16409,1303,102,75,2226,604,2066,573,160,82,5007,779,4884,753,123,92,7141,711
86000US33144,"33144",28996,1803,25823,1866,14026,1547,13846,1495,180,140,3524,847,2956,715,568,243,8273,1402,7820,1363,453,231,3173,514
86000US33145,"33145",30420,1803,24268,1880,14043,1502,13733,1467,310,161,2291,657,1927,530,364,192,7934,1108,7579,1083,355,155,6152,753
86000US33146,"33146",11730,750,9257,693,8019,667,7970,662,49,44,253,210,240,205,13,21,985,384,916,356,69,68,2473,379
86000US33147,"33147",47542,2341,41945,2532,15359,2020,15055,2005,304,163,5440,1285,4968,1179,472,194,21146,1800,20455,1729,691,274,5597,653
86000US33149,"33149",12943,61,11684,184,10360,425,10107,424,253,126,179,120,170,113,9,14,1145,377,1133,375,12,13,1259,192
86000US33150,"33150",29297,1680,24834,1769,11483,1385,11369,1380,114,84,3222,982,3009,906,213,114,10129,1498,9896,1462,233,146,4463,410
86000US33154,"33154",14634,33,11904,423,8518,930,8518,930,0,21,830,493,722,435,108,84,2556,922,2373,874,183,133,2730,418
86000US33155,"33155",46244,1373,40970,1451,28944,1731,28515,1703,429,201,3740,1075,3477,974,263,162,8286,1056,7795,1008,491,211,5274,590
86000US33156,"33156",33447,1090,29906,1181,24251,1261,24035,1257,216,107,853,389,759,343,94,93,4802,855,4424,816,378,195,3541,553
86000US33157,"33157",66981,1858,61388,1998,40150,2230,39600,2167,550,257,6549,1088,5740,1015,809,210,14689,1438,13976,1380,713,189,5593,682
86000US33158,"33158",6464,520,6138,551,5175,574,5169,574,6,11,230,175,223,172,7,12,733,271,706,262,27,29,326,108
86000US33160,"33160",39522,1185,28759,1258,21452,1417,21214,1391,238,144,2300,581,2093,544,207,124,5007,929,4805,918,202,121,10763,752
86000US33161,"33161",54116,1948,46910,2073,24178,1811,23828,1776,350,203,6210,1123,5223,852,987,418,16522,1757,15614,1582,908,311,7206,844
86000US33162,"33162",46915,1933,42759,2013,25151,2481,24978,2486,173,172,4360,1186,3910,1030,450,269,13248,1887,12050,1706,1198,448,4156,542
86000US33165,"33165",55181,1833,50555,1981,32761,2081,32054,1965,707,264,6324,1585,5426,1345,898,331,11470,1662,10913,1613,557,206,4626,690
86000US33166,"33166",22376,1009,19182,1008,12859,1083,12758,1066,101,68,1765,612,1547,545,218,118,4558,766,4305,699,253,144,3194,506
86000US33167,"33167",20558,1770,19151,1846,9078,1712,8949,1695,129,92,2161,740,2009,705,152,132,7912,1728,7575,1679,337,211,1407,321
86000US33168,"33168",26966,1726,25053,1748,13430,1681,13046,1576,384,236,3389,882,2763,693,626,284,8234,1091,7622,1027,612,152,1913,387
86000US33169,"33169",41356,1833,37163,1982,17757,1753,17521,1746,236,148,3614,858,3377,800,237,126,15792,1458,15106,1419,686,223,4193,486
86000US33170,"33170",13830,1395,13072,1411,7241,1429,7146,1411,95,109,1455,532,1239,462,216,120,4376,982,4120,935,256,188,758,231
86000US33172,"33172",43356,1588,38256,1733,22195,1795,22053,1777,142,105,4843,1050,4399,1004,444,181,11218,1582,10478,1477,740,263,5100,490
86000US33173,"33173",32164,1353,27815,1542,19281,1542,18940,1483,341,234,2338,730,2168,677,170,105,6196,1086,5926,1026,270,156,4349,528
86000US33174,"33174",31570,1587,27346,1639,16537,1599,16282,1585,255,135,2914,714,2629,616,285,166,7895,1275,7309,1163,586,239,4224,531
86000US33175,"33175",52955,1937,48648,2118,32096,2030,31570,2014,526,196,4893,1129,4415,1033,478,179,11659,1802,10757,1635,902,366,4307,622
86000US33176,"33176",52025,1658,45753,1689,31962,1940,31639,1904,323,165,4982,1456,4562,1362,420,173,8809,1523,8426,1470,383,164,6272,642
86000US33177,"33177",55916,1695,53048,1897,36767,2145,36358,2104,409,232,3890,923,3474,814,416,167,12391,1520,11434,1419,957,258,2868,482
86000US33178,"33178",52206,951,49118,1050,37355,1541,36811,1504,544,202,3553,860,3368,822,185,98,8210,1400,7655,1297,555,203,3088,517
86000US33179,"33179",43973,1851,36565,2050,23592,2143,23376,2135,216,150,3285,793,3055,751,230,102,9688,1408,9280,1332,408,201,7408,779
86000US33180,"33180",32202,1029,25529,1290,20036,1304,19984,1301,52,61,1064,489,1003,465,61,64,4429,983,4274,953,155,103,6673,732
86000US33181,"33181",19752,1346,15630,1473,9582,1238,9477,1212,105,124,2547,870,2197,742,350,293,3501,818,3338,780,163,101,4122,506
86000US33182,"33182",13697,642,13214,684,9614,901,9578,900,36,30,718,297,687,282,31,42,2882,710,2659,667,223,125,483,152
86000US33183,"33183",36610,1289,33568,1496,22571,1375,22450,1378,121,92,2319,655,2185,631,134,69,8678,1234,8388,1225,290,148,3042,531
86000US33184,"33184",21729,1640,20565,1675,12400,1430,12187,1405,213,149,2354,861,2193,827,161,106,5811,1392,5415,1324,396,185,1164,258
86000US33185,"33185",31291,1327,29828,1410,22340,1268,21950,1282,390,296,1979,559,1790,508,189,110,5509,1015,5209,982,300,123,1463,290
86000US33186,"33186",68357,2510,61809,2860,45206,2980,44694,2928,512,257,3412,761,3025,693,387,133,13191,1660,12539,1595,652,216,6548,798
86000US33187,"33187",19332,1184,18262,1287,13950,1437,13789,1425,161,141,1620,668,1438,576,182,139,2692,871,2374,779,318,162,1070,348
86000US33189,"33189",25190,1506,21651,1418,13930,1193,13769,1183,161,104,1386,507,1256,459,130,78,6335,1176,5979,1099,356,151,3539,721
86000US33190,"33190",16058,948,15051,1040,9886,1153,9830,1148,56,66,1070,443,892,395,178,99,4095,841,3819,776,276,168,1007,402
86000US33193,"33193",49855,1441,46505,1557,29889,1606,29431,1522,458,299,3272,942,2983,870,289,140,13344,1139,12484,1105,860,247,3350,617
86000US33194,"33194",5900,1054,5655,1081,4804,1091,4804,1091,0,19,29,44,29,44,0,19,822,592,648,426,174,250,245,151
86000US33196,"33196",52976,1967,49795,2126,36196,2144,35846,2114,350,170,3916,883,3479,748,437,230,9683,1373,9304,1330,379,143,3181,519
86000US33301,"33301",14198,989,7893,882,6745,704,6702,704,43,60,266,186,217,149,49,41,882,453,856,452,26,27,6305,773
86000US33304,"33304",18085,1231,9521,1180,6386,1139,6386,1139,0,21,857,538,772,471,85,98,2278,796,2244,784,34,43,8564,705
86000US33305,"33305",12039,799,6549,760,5290,722,5138,673,152,135,260,187,212,141,48,60,999,369,983,367,16,18,5490,532
86000US33306,"33306",3124,380,1890,342,1564,292,1552,291,12,21,126,107,118,99,8,13,200,164,188,151,12,20,1234,240
86000US33308,"33308",27124,902,16603,958,13403,905,13337,912,66,84,1165,409,1023,370,142,68,2035,495,1981,478,54,44,10521,758
86000US33309,"33309",40485,1976,32822,2193,18520,2134,18155,2126,365,231,3691,985,3179,861,512,224,10611,1934,9609,1717,1002,384,7663,992
86000US33311,"33311",75061,2784,63553,2964,23629,2325,23264,2328,365,201,6469,1742,5643,1485,826,334,33455,3003,31741,2774,1714,671,11508,926
86000US33312,"33312",54902,1969,45346,2084,27184,2155,26885,2118,299,155,5553,1624,4719,1253,834,712,12609,2158,11959,2059,650,255,9556,1231
86000US33313,"33313",62080,2342,53588,2489,24253,2126,23858,2126,395,208,6781,1416,6231,1321,550,223,22554,2060,21731,2047,823,283,8492,898
86000US33314,"33314",26057,1126,20611,1345,11000,1377,10876,1349,124,97,3012,1029,2328,769,684,412,6599,1384,6088,1255,511,232,5446,529
86000US33315,"33315",13630,1043,8601,1151,6597,1033,6536,1024,61,68,856,422,696,345,160,117,1148,541,986,453,162,149,5029,855
86000US33316,"33316",9376,681,5643,685,4549,579,4488,577,61,58,248,119,242,118,6,9,846,338,663,231,183,163,3733,418
86000US33317,"33317",38150,1569,33616,1644,22367,1806,21882,1765,485,242,3600,1102,2939,844,661,338,7649,1457,7369,1444,280,138,4534,670
86000US33319,"33319",46666,1856,37469,2025,21223,2118,20822,1941,401,409,5021,1068,4564,1009,457,196,11225,1353,10830,1297,395,164,9197,756
86000US33321,"33321",47146,1073,37238,1376,23247,1875,23074,1851,173,135,3472,867,3274,831,198,110,10519,1623,9738,1467,781,348,9908,932
86000US33322,"33322",39015,1417,30662,1587,22415,1411,22262,1411,153,92,1671,699,1409,585,262,149,6576,1067,6294,1000,282,158,8353,683
86000US33323,"33323",21629,1170,19050,1174,13904,1127,13767,1114,137,87,1021,364,875,306,146,93,4125,1012,4027,997,98,68,2579,397
86000US33324,"33324",48929,1385,39313,1617,24481,1778,24402,1773,79,53,3789,903,3446,840,343,161,11043,1356,10311,1303,732,265,9616,888
86000US33325,"33325",29319,1156,26472,1302,18537,1391,18481,1385,56,51,2750,809,2523,718,227,169,5185,908,4607,795,578,278,2847,529
86000US33326,"33326",33155,1127,30209,1225,23493,1272,23339,1258,154,94,2006,619,1730,537,276,132,4710,1134,4381,1007,329,210,2946,561
86000US33327,"33327",23811,1258,23317,1324,21014,1611,20928,1598,86,101,194,149,179,131,15,24,2109,836,2019,805,90,111,494,223
86000US33328,"33328",29293,1351,25374,1318,19089,1165,19029,1172,60,57,1200,457,1154,449,46,31,5085,943,4801,910,284,130,3919,652
86000US33330,"33330",15724,1111,14774,1201,11735,1239,11661,1223,74,70,588,308,554,290,34,38,2451,1183,2390,1165,61,66,950,398
86000US33331,"33331",25718,1289,24660,1321,21642,1312,21516,1285,126,93,1151,695,1070,617,81,90,1867,469,1796,450,71,92,1058,307
86000US33332,"33332",11577,1172,11093,1127,9960,1133,9698,1096,262,178,211,178,183,154,28,40,922,522,846,516,76,76,484,229
86000US33334,"33334",29407,1476,20700,1607,13137,1433,12918,1396,219,171,2887,767,2639,706,248,127,4676,914,4362,836,314,162,8707,907
86000US33351,"33351",35188,1261,30504,1636,19138,1676,19068,1665,70,74,3152,942,2709,801,443,212,8214,1569,7903,1500,311,159,4684,764
86000US33401,"33401",26898,1118,18620,1272,10132,1008,10042,1002,90,83,1814,623,1474,498,340,210,6674,1046,6293,1023,381,190,8278,756
86000US33403,"33403",12774,802,10153,874,6318,997,6318,997,0,21,1136,641,1031,601,105,116,2699,803,2563,779,136,78,2621,735
86000US33404,"33404",29134,810,24481,879,10163,1132,10047,1136,116,73,3091,810,2851,758,240,112,11227,1338,10967,1326,260,121,4653,607
86000US33405,"33405",20617,967,16745,1024,10016,1200,9924,1181,92,113,1421,600,1242,538,179,113,5308,1137,4998,1110,310,132,3872,567
86000US33406,"33406",25989,1202,21969,1286,13960,1357,13761,1343,199,133,2077,681,1835,611,242,145,5932,1133,5570,1035,362,204,4020,648
86000US33407,"33407",31032,1606,24322,1851,11345,1305,11229,1292,116,139,3202,909,2894,785,308,177,9775,1510,9217,1407,558,221,6710,847
86000US33408,"33408",18151,502,13308,574,10603,651,10550,641,53,57,720,224,713,224,7,13,1985,439,1930,429,55,42,4843,387
86000US33409,"33409",32482,1585,26302,1695,14913,1506,14739,1459,174,152,3926,1126,3139,871,787,353,7463,1169,6900,1092,563,212,6180,773
86000US33410,"33410",34750,1418,26600,1518,19165,1399,18827,1389,338,177,1894,727,1543,584,351,280,5541,939,5125,848,416,201,8150,733
86000US33411,"33411",71643,1817,62110,1997,44079,1916,43361,1874,718,277,4063,871,3365,691,698,306,13968,1865,13159,1785,809,298,9533,750
86000US33412,"33412",15467,977,13796,1101,11570,1163,11363,1112,207,131,935,487,829,437,106,84,1291,499,1261,494,30,35,1671,497
86000US33413,"33413",17444,1129,15954,1181,9660,1119,9525,1111,135,114,2139,756,1859,710,280,224,4155,979,3854,911,301,151,1490,433
86000US33414,"33414",61318,1083,55847,1194,45438,1462,45080,1428,358,145,3207,776,3024,744,183,92,7202,1117,6872,1082,330,138,5471,656
86000US33415,"33415",51438,1534,44219,1747,24966,1854,24532,1808,434,216,5240,1330,4716,1186,524,211,14013,1314,13117,1260,896,250,7219,700
86000US33417,"33417",33618,1301,25142,1369,15225,1275,14907,1214,318,194,2548,871,2222,807,326,154,7369,1206,7107,1162,262,181,8476,613
86000US33418,"33418",40635,1226,33283,1257,26751,1444,26631,1432,120,82,1979,633,1667,519,312,163,4553,961,4338,954,215,153,7352,880
86000US33426,"33426",23622,1121,16870,1388,11280,1166,11175,1156,105,107,1555,564,1396,503,159,97,4035,952,3743,879,292,170,6752,781
86000US33428,"33428",41311,1378,36521,1520,27646,1635,27374,1603,272,175,2479,714,2269,646,210,103,6396,990,6061,951,335,143,4790,586
86000US33430,"33430",22368,474,18833,641,7609,1115,7435,1093,174,118,3335,855,3024,744,311,154,7889,1266,7489,1215,400,172,3535,510
86000US33431,"33431",18815,1066,14235,1076,11268,1034,11221,1015,47,60,1091,630,966,546,125,94,1876,586,1765,537,111,109,4580,520
86000US33432,"33432",20443,991,13104,1023,10496,966,10330,950,166,134,1006,605,974,594,32,43,1602,477,1567,471,35,44,7339,680
86000US33433,"33433",39620,1439,29379,1423,23780,1388,23707,1381,73,62,1092,414,914,337,178,105,4507,839,4304,799,203,112,10241,729
86000US33434,"33434",20422,861,15173,991,11951,827,11920,820,31,35,633,283,617,277,16,17,2589,510,2532,505,57,55,5249,457
86000US33435,"33435",35907,1211,28124,1434,17200,1219,17071,1218,129,99,3245,1066,2714,769,531,490,7679,1193,7192,1134,487,180,7783,917
86000US33436,"33436",44228,1570,34970,1541,25753,1437,25579,1434,174,94,3040,964,2526,799,514,226,6177,1243,5822,1158,355,211,9258,795
86000US33437,"33437",38053,1394,29369,1356,25671,1404,25569,1403,102,126,1385,602,1251,594,134,120,2313,493,2222,456,91,91,8684,859
86000US33438,"33438",367,182,349,180,220,158,220,158,0,14,76,128,76,128,0,14,53,82,36,55,17,28,18,27
86000US33440,"33440",18635,899,16190,1021,9538,971,9123,950,415,253,2060,743,1739,651,321,146,4592,1021,4233,930,359,182,2445,440
86000US33441,"33441",27223,1171,20099,1310,11793,1255,11637,1240,156,79,1567,560,1372,472,195,127,6739,1205,6121,1129,618,218,7124,701
86000US33442,"33442",28610,925,20424,968,14913,1130,14827,1105,86,83,1492,398,1401,377,91,56,4019,877,3806,840,213,130,8186,662
86000US33444,"33444",24232,1017,18457,1016,10238,1120,10160,1123,78,63,1886,482,1689,444,197,80,6333,1032,5863,963,470,295,5775,667
86000US33445,"33445",31411,1069,22444,1279,15266,1361,15123,1338,143,132,2190,863,1991,815,199,98,4988,911,4486,793,502,204,8967,684
86000US33446,"33446",26006,1336,19133,1311,15903,1199,15903,1199,0,25,1750,832,1623,794,127,98,1480,455,1467,452,13,21,6873,678
86000US33449,"33449",12321,977,11677,979,9950,1095,9950,1095,0,21,894,489,746,427,148,113,833,458,781,433,52,61,644,213
86000US33455,"33455",21683,1033,17017,1046,13556,991,13380,988,176,128,979,418,870,354,109,90,2482,734,2396,720,86,67,4666,419
86000US33458,"33458",58256,988,48486,1395,36884,1778,36491,1695,393,280,2872,930,2383,743,489,252,8730,1121,8360,1118,370,134,9770,1027
86000US33460,"33460",31977,724,24413,966,12589,1469,12101,1341,488,368,5144,1036,4329,915,815,338,6680,1288,6087,1188,593,230,7564,823
86000US33461,"33461",46978,1478,39052,1692,20420,1600,20064,1564,356,189,7487,1588,6594,1424,893,295,11145,1340,10450,1253,695,233,7926,962
86000US33462,"33462",32941,1300,25168,1447,15357,1494,15252,1500,105,107,2969,868,2670,793,299,136,6842,1354,6312,1155,530,373,7773,841
86000US33463,"33463",63362,1342,56906,1574,34515,2020,34059,2075,456,258,6355,1184,5396,1031,959,280,16036,1542,14941,1434,1095,266,6456,795
86000US33467,"33467",54223,1638,46888,1857,36837,1897,36390,1855,447,221,2694,699,2293,595,401,171,7357,1153,6811,1052,546,231,7335,792
86000US33469,"33469",14797,695,11546,728,9725,731,9689,728,36,36,424,256,423,256,1,2,1397,504,1363,499,34,41,3251,404
86000US33470,"33470",27301,1020,24882,1118,20379,1268,20074,1255,305,153,2145,735,1755,591,390,255,2358,639,2212,599,146,86,2419,525
86000US33471,"33471",5666,666,4491,634,2783,599,2783,599,0,19,399,191,361,181,38,42,1309,466,1285,463,24,27,1175,290
86000US33472,"33472",19767,1234,16933,1233,14533,1009,14353,971,180,160,294,273,251,238,43,59,2106,797,1906,682,200,180,2834,531
86000US33473,"33473",12210,1323,11684,1391,10495,1279,10442,1250,53,77,233,198,233,198,0,21,956,774,956,774,0,21,526,211
86000US33476,"33476",8005,537,6665,530,3372,588,3340,598,32,57,695,336,678,328,17,30,2598,609,2589,606,9,18,1340,309
86000US33477,"33477",12594,771,9020,807,7840,727,7773,701,67,71,345,154,313,142,32,24,835,374,778,346,57,70,3574,383
86000US33478,"33478",14067,905,12966,908,11946,899,11560,820,386,280,353,227,273,169,80,68,667,362,646,357,21,24,1101,261
86000US33480,"33480",10031,147,7037,364,6488,373,6387,367,101,74,31,47,31,47,0,21,518,220,500,215,18,20,2994,342
86000US33483,"33483",12421,662,8591,738,6673,604,6635,596,38,52,975,518,879,497,96,84,943,414,880,395,63,53,3830,490
86000US33484,"33484",25902,931,16660,1068,13002,1020,12987,1024,15,23,902,437,861,420,41,48,2756,664,2609,649,147,84,9242,697
86000US33486,"33486",22806,1193,18441,1222,15097,1164,14916,1138,181,149,1112,461,988,412,124,77,2232,640,2093,600,139,103,4365,532
86000US33487,"33487",20653,953,15368,1028,12340,883,12176,885,164,117,1013,444,948,419,65,81,2015,557,1953,534,62,56,5285,652
86000US33493,"33493",1665,224,1496,221,728,196,725,194,3,15,288,129,274,122,14,16,480,168,446,158,34,22,169,67
86000US33496,"33496",22511,928,17731,1136,14384,1041,14351,1043,33,50,1197,519,1137,496,60,68,2150,556,2097,531,53,50,4780,499
86000US33498,"33498",15150,765,13814,831,12147,787,12138,788,9,14,619,340,584,313,35,57,1048,373,1003,361,45,42,1336,351
86000US33503,"33503",162,135,146,141,146,141,146,141,0,14,0,14,0,14,0,14,0,14,0,14,0,14,16,21
86000US33510,"33510",29397,1370,25240,1414,16591,1374,16510,1373,81,81,2475,1011,2082,792,393,319,6174,1162,5607,1044,567,233,4157,442
86000US33511,"33511",58401,1829,48083,2031,31639,1751,31463,1774,176,110,4369,1169,3768,1029,601,280,12075,1780,11246,1556,829,351,10318,907
86000US33513,"33513",10465,890,9046,880,6801,836,6754,838,47,40,648,308,594,283,54,47,1597,521,1575,522,22,26,1419,295
86000US33514,"33514",2717,1086,2340,1089,1280,458,1234,442,46,55,774,1020,767,1020,7,12,286,162,278,162,8,8,377,172
86000US33521,"33521",557,195,434,179,222,131,222,131,0,14,36,46,36,46,0,14,176,122,172,119,4,8,123,58
86000US33523,"33523",18733,1184,15885,1260,10089,1065,9950,1060,139,88,1519,590,1233,463,286,168,4277,897,3994,822,283,147,2848,455
86000US33525,"33525",19229,1100,16884,1130,11712,1004,11638,997,74,55,1339,380,1219,363,120,59,3833,664,3600,634,233,107,2345,320
86000US33527,"33527",14511,1087,12748,1117,10408,1017,10283,979,125,124,891,682,806,624,85,71,1449,603,1263,538,186,97,1763,350
86000US33534,"33534",17123,873,15027,1020,8826,1117,8746,1100,80,62,1666,655,1500,594,166,105,4535,913,4297,905,238,96,2096,410
86000US33538,"33538",4728,544,3695,510,2670,432,2611,416,59,62,199,166,194,163,5,9,826,316,753,282,73,66,1033,221
86000US33540,"33540",8543,758,6434,804,4587,677,4568,677,19,19,705,316,633,278,72,46,1142,484,1086,469,56,47,2109,307
86000US33541,"33541",20920,851,16791,925,13115,1068,13082,1065,33,32,785,328,720,299,65,63,2891,660,2688,606,203,115,4129,510
86000US33542,"33542",21664,786,16815,821,11433,944,11328,917,105,77,1328,506,1059,404,269,156,4054,700,3657,614,397,157,4849,484
86000US33543,"33543",28129,1111,25552,1203,19976,1289,19900,1280,76,85,1594,423,1440,391,154,102,3982,780,3663,690,319,162,2577,299
86000US33544,"33544",28187,1105,25189,1261,20656,1349,20401,1344,255,204,1340,576,1147,482,193,182,3193,683,2912,627,281,112,2998,551
86000US33545,"33545",19592,866,17844,1003,14205,1069,14184,1066,21,36,1109,477,1003,452,106,63,2530,576,2363,537,167,148,1748,367
86000US33547,"33547",25750,953,24153,1073,20317,1135,20226,1128,91,95,956,458,799,382,157,123,2880,640,2669,593,211,89,1597,321
86000US33548,"33548",7213,516,6395,544,5435,561,5343,522,92,88,350,214,333,208,17,26,610,310,600,307,10,16,818,207
86000US33549,"33549",17847,942,15342,1015,12644,954,12501,956,143,123,811,429,677,349,134,113,1887,511,1786,474,101,77,2505,354
86000US33556,"33556",23182,1201,21148,1268,18491,1354,18378,1333,113,69,1039,482,999,475,40,40,1618,484,1561,463,57,47,2034,352
86000US33558,"33558",24238,815,20929,912,16530,929,16484,918,46,50,1290,442,1224,428,66,51,3109,767,2873,707,236,130,3309,407
86000US33559,"33559",18445,1208,14029,1226,10114,1144,10022,1122,92,111,1152,420,926,358,226,112,2763,813,2443,654,320,186,4416,709
86000US33563,"33563",27753,973,23827,1056,15267,1266,15198,1271,69,59,2727,935,2426,808,301,237,5833,849,5518,824,315,133,3926,597
86000US33565,"33565",17606,1061,14852,1098,11699,1010,11524,1036,175,156,1319,566,1157,516,162,79,1834,425,1644,375,190,102,2754,531
86000US33566,"33566",21330,1233,19090,1271,14784,1221,14516,1189,268,152,988,427,851,371,137,92,3318,834,3147,807,171,118,2240,388
86000US33567,"33567",11701,894,10632,904,7817,888,7801,886,16,16,944,501,810,431,134,128,1871,597,1768,554,103,95,1069,275
86000US33569,"33569",28428,1334,25381,1552,19254,1325,19048,1295,206,128,1591,690,1362,575,229,203,4536,1100,4226,1061,310,145,3047,524
86000US33570,"33570",29941,1519,26263,1656,16932,1620,16565,1528,367,274,3524,798,3031,711,493,171,5807,1177,5410,1104,397,189,3678,447
86000US33572,"33572",20369,795,17963,833,15121,835,15121,835,0,25,849,414,727,369,122,79,1993,470,1731,412,262,120,2406,302
86000US33573,"33573",22820,758,15954,813,14455,772,14434,771,21,35,555,286,531,281,24,28,944,333,926,328,18,29,6866,450
86000US33576,"33576",4498,373,3788,382,2966,352,2936,350,30,30,262,119,246,113,16,19,560,236,529,224,31,25,710,135
86000US33578,"33578",52409,2029,42523,2180,29489,1981,29134,1944,355,234,2640,830,2341,775,299,157,10394,1332,9552,1240,842,259,9886,830
86000US33579,"33579",35966,1518,32903,1608,25142,1638,24913,1612,229,173,1297,533,1196,502,101,76,6464,1387,6071,1368,393,142,3063,616
86000US33584,"33584",26635,1412,22796,1537,15754,1401,15652,1391,102,61,1481,554,1336,505,145,113,5561,841,5052,775,509,157,3839,595
86000US33585,"33585",1096,230,874,227,815,223,797,224,18,31,41,45,41,45,0,14,18,29,18,29,0,14,222,88
86000US33592,"33592",11519,881,9720,951,6161,953,5989,948,172,137,915,395,813,352,102,83,2644,684,2375,625,269,129,1799,296
86000US33594,"33594",34800,1562,30046,1588,22876,1608,22733,1597,143,76,2494,821,2276,782,218,110,4676,862,4371,824,305,112,4754,931
86000US33596,"33596",30822,1076,28575,1246,23485,1478,23299,1456,186,115,2118,669,1852,570,266,170,2972,791,2809,753,163,76,2247,355
86000US33597,"33597",7688,798,6598,869,5464,861,5381,879,83,118,101,88,99,86,2,4,1033,469,898,429,135,104,1090,316
86000US33598,"33598",19921,1033,17930,1036,13310,1141,13161,1119,149,88,1026,498,831,409,195,102,3594,1007,3194,843,400,264,1991,493
86000US33602,"33602",15257,761,8282,773,5816,715,5756,694,60,72,513,244,444,201,69,62,1953,437,1924,435,29,22,6975,551
86000US33603,"33603",21254,1130,15835,1197,8643,1113,8501,1116,142,108,1084,356,946,308,138,71,6108,921,5710,864,398,176,5419,568
86000US33604,"33604",39505,1607,30940,1715,17330,1554,16794,1524,536,306,3655,768,3053,661,602,220,9955,1286,9102,1160,853,257,8565,683
86000US33605,"33605",17284,894,12980,976,4909,699,4791,680,118,81,1909,523,1626,440,283,168,6162,774,5934,755,228,64,4304,338
86000US33606,"33606",17086,999,10062,983,7585,823,7516,815,69,51,720,248,670,240,50,37,1757,547,1615,504,142,112,7024,660
86000US33607,"33607",24332,1322,16673,1524,8403,1104,8306,1096,97,76,1758,575,1552,515,206,120,6512,1267,6059,1150,453,327,7659,664
86000US33609,"33609",18299,1146,12544,1153,9682,1069,9661,1070,21,23,898,494,725,385,173,131,1964,568,1911,551,53,55,5755,632
86000US33610,"33610",46453,2304,38983,2617,17232,2612,16979,2583,253,171,3683,707,3405,653,278,128,18068,1648,17215,1585,853,237,7470,820
86000US33611,"33611",32687,1179,23366,1409,17692,1190,17561,1188,131,89,2032,576,1826,522,206,125,3642,777,3365,715,277,164,9321,796
86000US33612,"33612",51149,1631,39088,1876,16686,1631,16535,1616,151,102,5286,1043,4747,980,539,209,17116,1592,16048,1500,1068,267,12061,766
86000US33613,"33613",35131,1680,20085,1482,10738,1397,10632,1372,106,120,2517,785,2228,678,289,161,6830,1149,6284,1055,546,267,15046,1020
86000US33614,"33614",48591,1991,38123,2189,20227,1695,19961,1696,266,171,5750,1323,5055,1165,695,248,12146,1802,11330,1717,816,260,10468,870
86000US33615,"33615",47276,2188,38183,2328,24302,2122,24109,2118,193,106,3962,1148,3462,971,500,246,9919,1388,9421,1302,498,229,9093,1025
86000US33616,"33616",16781,1074,12662,1120,7591,826,7568,825,23,29,1632,642,1403,544,229,129,3439,628,3235,607,204,105,4119,561
86000US33617,"33617",46741,2050,34805,2253,18161,1752,17912,1775,249,172,3467,911,3042,866,425,252,13177,2086,12680,2026,497,236,11936,932
86000US33618,"33618",27152,1148,21737,1315,17344,1212,17304,1213,40,38,627,315,558,263,69,72,3766,849,3454,781,312,191,5415,583
86000US33619,"33619",37307,2145,29854,2390,13901,1471,13739,1464,162,87,3103,728,2742,660,361,119,12850,1977,12007,1730,843,347,7453,717
86000US33620,"33620",11,19,0,19,0,19,0,19,0,19,0,19,0,19,0,19,0,19,0,19,0,19,11,19
86000US33621,"33621",2425,248,2420,248,2313,245,2301,242,12,19,24,35,24,35,0,14,83,80,83,80,0,14,5,8
86000US33624,"33624",39612,1400,32330,1538,22371,1543,22230,1539,141,113,3859,991,3279,861,580,203,6100,1033,5588,921,512,209,7282,707
86000US33625,"33625",27254,1234,22640,1441,15823,1285,15617,1267,206,145,1797,740,1609,622,188,155,5020,857,4782,799,238,161,4614,608
86000US33626,"33626",30743,1324,26514,1517,22156,1694,22056,1684,100,71,1004,486,943,470,61,56,3354,728,3084,680,270,122,4229,630
86000US33629,"33629",26992,910,22657,1068,19513,1150,19460,1157,53,78,798,401,718,351,80,73,2346,594,2249,569,97,68,4335,588
86000US33634,"33634",22698,1142,19124,1260,11868,1368,11662,1372,206,181,2414,791,2106,680,308,161,4842,1139,4387,1032,455,239,3574,600
86000US33635,"33635",18639,1151,15097,1226,10507,1248,10449,1240,58,92,800,381,685,297,115,117,3790,908,3609,857,181,118,3542,562
86000US33637,"33637",17555,1088,12876,1306,6795,846,6738,848,57,40,1566,629,1425,582,141,92,4515,1061,4294,975,221,147,4679,664
86000US33647,"33647",71004,1879,60796,2026,48669,2109,48109,2102,560,242,3293,875,2978,805,315,164,8834,1187,8420,1143,414,159,10208,1205
86000US33701,"33701",14496,1101,7028,1021,4909,796,4891,797,18,27,436,268,419,259,17,25,1683,698,1583,624,100,96,7468,596
86000US33702,"33702",31531,1410,23480,1562,15758,1401,15674,1395,84,69,1936,548,1723,492,213,98,5786,1024,5524,1008,262,160,8051,682
86000US33703,"33703",25609,1059,19776,1138,14157,1277,14032,1243,125,126,1676,703,1451,573,225,194,3943,640,3786,626,157,110,5833,534
86000US33704,"33704",16884,752,12560,849,9827,811,9787,806,40,45,681,294,557,260,124,88,2052,523,1869,485,183,79,4324,444
86000US33705,"33705",27679,1415,21122,1422,12059,1355,12013,1355,46,39,1731,562,1600,535,131,66,7332,1104,7053,1103,279,158,6557,581
86000US33706,"33706",16300,74,11525,484,10204,596,10118,606,86,78,324,142,324,142,0,21,997,415,988,410,9,14,4775,476
86000US33707,"33707",24035,740,16343,885,11640,809,11543,791,97,98,1517,423,1197,328,320,127,3186,590,2898,531,288,152,7692,659
86000US33708,"33708",16078,601,11206,577,9525,560,9489,559,36,29,460,223,396,184,64,57,1221,352,1151,336,70,46,4872,392
86000US33709,"33709",23989,1116,17459,1203,11300,952,11049,921,251,133,1411,403,1364,387,47,41,4748,813,4441,733,307,183,6530,532
86000US33710,"33710",33705,1093,26591,1243,19015,1108,18816,1096,199,181,1460,534,1088,358,372,247,6116,1096,5815,1050,301,138,7114,560
86000US33711,"33711",18096,1496,14261,1500,7350,951,7309,942,41,33,963,484,870,425,93,118,5948,1240,5640,1152,308,194,3835,596
86000US33712,"33712",24487,1371,18840,1333,9941,1106,9902,1097,39,45,1613,513,1526,498,87,68,7286,1207,7038,1169,248,138,5647,746
86000US33713,"33713",32028,1436,23783,1480,15315,1166,15164,1165,151,86,2732,628,2478,603,254,117,5736,1149,5343,1096,393,159,8245,737
86000US33714,"33714",21746,1499,17096,1571,6936,1004,6844,978,92,87,3852,1228,3500,1124,352,176,6308,1476,5829,1377,479,245,4650,667
86000US33715,"33715",7296,532,5800,528,5279,512,5258,507,21,33,195,158,171,147,24,25,326,174,311,167,15,21,1496,185
86000US33716,"33716",17971,1251,10019,1515,5682,1101,5449,1015,233,292,1580,752,1389,616,191,172,2757,762,2487,697,270,147,7952,797
86000US33744,"33744",0,14,0,14,0,14,0,14,0,14,0,14,0,14,0,14,0,14,0,14,0,14,0,14
86000US33755,"33755",25762,1266,20246,1451,9628,1285,9595,1285,33,54,2069,685,1847,592,222,129,8549,1407,8128,1368,421,180,5516,696
86000US33756,"33756",33118,1313,25111,1446,15914,1207,15800,1196,114,113,2904,905,2664,818,240,149,6293,1185,6092,1185,201,112,8007,771
86000US33759,"33759",17923,814,13446,900,8293,787,8293,787,0,21,1992,662,1776,570,216,120,3161,627,3044,601,117,74,4477,559
86000US33760,"33760",16468,747,11774,936,7448,793,7260,754,188,139,1210,337,1107,304,103,58,3116,695,2876,670,240,103,4694,597
86000US33761,"33761",19682,872,15494,979,12326,1044,12292,1031,34,45,950,394,922,384,28,35,2218,625,2162,614,56,48,4188,540
86000US33762,"33762",5683,404,3993,397,3419,375,3393,370,26,30,214,125,214,125,0,19,360,171,352,169,8,12,1690,232
86000US33763,"33763",19521,1055,13082,1074,9464,1318,9314,1289,150,158,670,339,640,330,30,30,2948,749,2779,714,169,94,6439,625
86000US33764,"33764",27180,1195,21030,1217,15759,1256,15737,1258,22,35,1945,579,1698,505,247,169,3326,707,3082,632,244,167,6150,649
86000US33765,"33765",14588,1163,10820,1265,7558,1280,7495,1270,63,69,793,399,666,327,127,89,2469,694,2315,653,154,111,3768,481
86000US33767,"33767",7452,499,5459,476,4715,431,4689,425,26,28,385,216,348,200,37,24,359,217,348,212,11,17,1993,284
86000US33770,"33770",26515,1394,18699,1465,12555,1168,12481,1149,74,83,1418,633,1245,547,173,118,4726,1008,4383,953,343,138,7816,865
86000US33771,"33771",29787,1530,21406,1544,14888,1550,14778,1544,110,101,1466,584,1391,562,75,68,5052,1096,4555,971,497,195,8381,633
86000US33772,"33772",22809,901,17433,993,12399,961,12267,938,132,110,827,345,737,291,90,72,4207,749,3899,685,308,140,5376,550
86000US33773,"33773",17433,1016,13857,956,10295,891,10147,880,148,99,929,352,821,326,108,76,2633,594,2509,553,124,70,3576,366
86000US33774,"33774",18036,1107,14338,1114,9771,898,9684,883,87,75,513,328,436,249,77,94,4054,1036,3723,947,331,165,3698,461
86000US33776,"33776",13504,684,12014,733,9685,683,9659,684,26,29,568,390,540,388,28,20,1761,373,1651,363,110,105,1490,243
86000US33777,"33777",16459,874,13537,879,10391,849,10181,840,210,164,1005,347,823,276,182,117,2141,535,2049,509,92,56,2922,373
86000US33778,"33778",14457,917,11275,917,8059,1061,7972,1050,87,84,962,378,890,361,72,49,2254,602,2067,522,187,157,3182,243
86000US33781,"33781",24549,983,19368,1011,13170,1228,13070,1227,100,81,2294,744,2013,624,281,173,3904,864,3598,790,306,194,5181,518
86000US33782,"33782",23167,971,18370,1138,12167,1116,12011,1104,156,125,2241,768,1877,632,364,170,3962,848,3622,728,340,233,4797,582
86000US33785,"33785",5432,169,3794,293,2919,296,2908,296,11,16,131,107,131,107,0,19,744,279,616,203,128,101,1638,242
86000US33786,"33786",1565,115,1227,127,1071,113,1071,113,0,14,54,35,51,33,3,5,102,68,100,68,2,4,338,82
86000US33801,"33801",31138,1621,24944,1521,13599,1305,13526,1310,73,58,3035,771,2734,704,301,177,8310,1247,7575,1105,735,418,6194,629
86000US33803,"33803",29130,1234,23453,1211,15585,1334,15365,1329,220,117,1811,635,1465,496,346,188,6057,984,5446,891,611,236,5677,544
86000US33805,"33805",24968,1238,20043,1338,10680,1205,10615,1200,65,41,2356,645,2134,614,222,101,7007,1046,6679,1025,328,115,4925,569
86000US33809,"33809",30030,1430,26148,1514,19600,1344,19320,1325,280,168,2342,769,1978,670,364,150,4206,796,3932,734,274,157,3882,535
86000US33810,"33810",50905,2260,43413,2389,31691,2254,31244,2233,447,194,3543,816,3201,786,342,123,8179,1361,7332,1247,847,268,7492,746
86000US33811,"33811",22285,1050,19171,1065,14874,1148,14770,1135,104,93,1278,329,1157,306,121,68,3019,650,2844,630,175,73,3114,427
86000US33812,"33812",12913,923,11970,986,9353,1035,9314,1033,39,62,1081,567,1031,547,50,43,1536,555,1392,470,144,112,943,258
86000US33813,"33813",38194,1630,33663,1558,28067,1422,27863,1426,204,117,1389,473,1304,446,85,75,4207,728,3952,680,255,127,4531,717
86000US33815,"33815",15081,1246,11670,1259,7603,1084,7553,1083,50,62,940,422,897,427,43,56,3127,857,2924,770,203,159,3411,523
86000US33823,"33823",33455,1128,29448,1308,19155,1395,18991,1399,164,78,2938,796,2488,699,450,211,7355,1037,6769,971,586,168,4007,430
86000US33825,"33825",24255,1044,20808,1188,14395,1189,14348,1181,47,63,1550,561,1239,436,311,176,4863,1053,4569,997,294,163,3447,446
86000US33827,"33827",2798,435,2377,414,1888,352,1871,345,17,28,126,162,98,119,28,43,363,224,347,213,16,16,421,151
86000US33830,"33830",28157,1198,24694,1302,16064,1199,15833,1174,231,134,1986,560,1662,480,324,128,6644,959,6253,901,391,149,3463,475
86000US33834,"33834",5854,586,5215,615,3697,633,3685,634,12,18,300,317,300,317,0,19,1218,461,1145,442,73,68,639,300
86000US33837,"33837",30572,1956,27100,2066,19247,1842,19188,1836,59,54,2121,719,1674,583,447,196,5732,1445,5376,1331,356,193,3472,600
86000US33838,"33838",4358,103,4005,190,1654,481,1654,481,0,14,48,84,48,84,0,14,2303,490,2188,426,115,110,353,170
86000US33839,"33839",3356,517,2864,521,1883,508,1860,505,23,27,303,189,283,185,20,18,678,252,629,255,49,37,492,161
86000US33841,"33841",8858,411,7514,413,5503,577,5463,575,40,37,648,390,612,387,36,24,1363,364,1324,351,39,35,1344,278
86000US33843,"33843",9655,530,8286,586,5953,775,5919,776,34,34,859,389,765,343,94,67,1474,348,1437,343,37,34,1369,288
86000US33844,"33844",36462,1361,31363,1511,19794,1767,19614,1730,180,159,2948,978,2613,859,335,178,8621,1398,8224,1307,397,193,5099,676
86000US33847,"33847",176,86,161,88,124,100,124,100,0,14,0,14,0,14,0,14,37,38,25,26,12,12,15,23
86000US33848,"33848",995,780,964,777,332,406,332,406,0,14,138,219,138,219,0,14,494,605,494,605,0,14,31,47
86000US33849,"33849",1171,433,941,368,740,358,740,358,0,14,201,230,188,225,13,20,0,14,0,14,0,14,230,323
86000US33850,"33850",8315,630,6825,694,4507,877,4441,848,66,88,638,413,618,406,20,31,1680,727,1570,669,110,128,1490,466
86000US33851,"33851",1153,260,1075,265,684,258,684,258,0,14,54,77,38,55,16,23,337,189,309,169,28,40,78,36
86000US33852,"33852",20655,1263,17326,1328,12836,1245,12744,1232,92,90,996,532,967,515,29,44,3494,1150,3019,839,475,407,3329,434
86000US33853,"33853",11436,833,9621,834,5536,902,5536,902,0,21,760,518,691,464,69,67,3325,933,3028,765,297,343,1815,318
86000US33854,"33854",294,137,126,128,126,128,126,128,0,14,0,14,0,14,0,14,0,14,0,14,0,14,168,75
86000US33855,"33855",0,14,0,14,0,14,0,14,0,14,0,14,0,14,0,14,0,14,0,14,0,14,0,14
86000US33856,"33856",270,112,124,73,124,73,124,73,0,14,0,14,0,14,0,14,0,14,0,14,0,14,146,89
86000US33857,"33857",2377,466,1906,478,1708,513,1708,513,0,14,0,14,0,14,0,14,198,215,198,215,0,14,471,191
86000US33859,"33859",10538,1272,8544,1182,5164,660,5116,643,48,56,664,435,582,398,82,61,2716,1049,2389,949,327,246,1994,405
86000US33860,"33860",26869,1561,23233,1711,16118,1414,16091,1408,27,35,2249,1131,1882,1025,367,292,4866,1059,4400,974,466,196,3636,783
86000US33865,"33865",958,457,920,454,625,380,592,366,33,53,0,14,0,14,0,14,295,357,295,357,0,14,38,33
86000US33867,"33867",327,153,206,102,206,102,206,102,0,14,0,14,0,14,0,14,0,14,0,14,0,14,121,99
86000US33868,"33868",10463,812,9359,832,6898,716,6815,693,83,89,582,219,513,196,69,45,1879,681,1616,505,263,197,1104,209
86000US33870,"33870",21409,1357,17145,1384,10061,1177,9627,1093,434,230,2619,1007,2373,945,246,132,4465,962,3983,805,482,228,4264,439
86000US33872,"33872",15803,982,12697,1050,10778,993,10689,983,89,87,416,250,416,250,0,21,1503,577,1462,562,41,54,3106,405
86000US33873,"33873",13645,827,11856,870,7759,1005,7746,1006,13,21,1193,473,1082,424,111,92,2904,994,2869,995,35,37,1789,391
86000US33875,"33875",11509,957,9330,911,7678,1009,7678,1009,0,21,523,388,432,313,91,84,1129,475,1055,445,74,82,2179,550
86000US33876,"33876",4888,724,4076,724,3618,681,3618,681,0,14,54,85,54,85,0,14,404,267,335,226,69,61,812,256
86000US33877,"33877",618,741,618,741,204,321,204,321,0,14,0,14,0,14,0,14,414,673,414,673,0,14,0,14
86000US33880,"33880",40490,2354,33926,2411,20367,2060,20179,2008,188,130,3882,1199,3541,1102,341,157,9677,1783,8843,1595,834,343,6564,900
86000US33881,"33881",34219,1299,28485,1473,16642,1512,16531,1500,111,76,3611,1189,3263,1099,348,163,8232,1341,7746,1224,486,249,5734,616
86000US33884,"33884",31378,1496,27063,1487,19360,1451,19141,1424,219,124,1970,733,1782,628,188,135,5733,1063,5485,1011,248,131,4315,496
86000US33890,"33890",4773,652,4257,649,3368,645,3368,645,0,14,221,181,221,181,0,14,668,271,589,237,79,59,516,167
86000US33896,"33896",11654,1302,8973,1152,5689,876,5600,855,89,66,1559,638,1271,508,288,195,1725,699,1623,677,102,67,2681,509
86000US33897,"33897",22752,1857,19665,2060,14596,1855,14461,1819,135,121,1596,924,1501,910,95,83,3473,1005,3246,922,227,170,3087,830
86000US33898,"33898",16888,1592,14246,1579,9057,1077,8955,1067,102,95,1154,431,1105,418,49,36,4035,1134,3786,1094,249,143,2642,399
86000US33901,"33901",19539,1069,13905,1159,8248,1032,8222,1038,26,41,2011,750,1876,718,135,101,3646,765,3443,716,203,117,5634,501
86000US33903,"33903",22531,1245,16369,1321,12018,1237,11845,1228,173,123,1456,635,1260,542,196,142,2895,823,2747,792,148,80,6162,714
86000US33904,"33904",30941,1627,24326,1719,18264,1455,18020,1392,244,175,2008,615,1862,572,146,112,4054,908,3757,844,297,184,6615,579
86000US33905,"33905",36014,1756,30437,1730,19988,1796,19714,1746,274,196,2984,698,2713,628,271,135,7465,1389,6936,1329,529,171,5577,711
86000US33907,"33907",23852,1623,17179,1787,8948,1047,8922,1050,26,40,4351,1292,4082,1193,269,137,3880,1000,3793,989,87,49,6673,751
86000US33908,"33908",35620,1606,26373,1582,22639,1493,22400,1466,239,158,919,392,850,364,69,58,2815,765,2536,684,279,218,9247,706
86000US33909,"33909",31729,1764,28602,1736,20827,1563,20351,1599,476,318,2437,798,2104,659,333,225,5338,1271,5013,1207,325,172,3127,595
86000US33912,"33912",18514,1040,14981,1065,13159,944,13110,934,49,35,662,534,631,537,31,26,1160,405,1130,402,30,23,3533,415
86000US33913,"33913",24001,1215,20424,1265,17285,1246,17062,1225,223,192,1224,782,1046,648,178,184,1915,591,1749,534,166,104,3577,479
86000US33914,"33914",38281,1955,32654,2298,27326,2362,26823,2242,503,384,2024,986,1743,882,281,206,3304,829,3049,777,255,134,5627,808
86000US33916,"33916",24660,1501,19917,1532,9427,1500,9427,1500,0,25,2037,755,1875,712,162,111,8453,1235,8106,1185,347,157,4743,508
86000US33917,"33917",29927,1290,23176,1547,17262,1232,17070,1204,192,127,2038,702,1638,497,400,339,3876,1253,3598,1216,278,174,6751,730
86000US33919,"33919",30250,1243,22734,1416,16163,1080,16109,1067,54,74,2353,812,2067,710,286,208,4218,798,4052,751,166,123,7516,589
86000US33920,"33920",6132,636,5626,644,3931,487,3801,459,130,121,443,236,407,226,36,43,1252,471,1215,459,37,36,506,136
86000US33921,"33921",613,213,493,204,477,208,477,208,0,14,16,25,16,25,0,14,0,14,0,14,0,14,120,70
86000US33922,"33922",4108,580,3283,554,2356,382,2297,377,59,65,468,409,455,406,13,19,459,299,417,264,42,46,825,200
86000US33924,"33924",67,48,46,46,46,46,46,46,0,14,0,14,0,14,0,14,0,14,0,14,0,14,21,17
86000US33928,"33928",25041,619,20516,733,17983,852,17950,851,33,56,1141,589,1012,534,129,108,1392,521,1308,506,84,63,4525,527
86000US33930,"33930",930,482,840,504,397,349,397,349,0,14,0,14,0,14,0,14,443,352,430,342,13,23,90,99
86000US33931,"33931",10527,336,7507,470,6738,482,6686,485,52,47,178,233,178,233,0,21,591,284,591,284,0,21,3020,433
86000US33935,"33935",22519,1377,20179,1486,13370,1551,12966,1486,404,321,2089,674,1848,594,241,136,4720,1323,4339,1205,381,204,2340,451
86000US33936,"33936",24465,1615,20721,1743,11848,1415,11822,1407,26,39,2503,933,2073,739,430,246,6370,1295,5892,1207,478,188,3744,474
86000US33944,"33944",219,302,219,302,219,302,219,302,0,14,0,14,0,14,0,14,0,14,0,14,0,14,0,14
86000US33945,"33945",0,14,0,14,0,14,0,14,0,14,0,14,0,14,0,14,0,14,0,14,0,14,0,14
86000US33946,"33946",2104,379,1693,324,1571,299,1571,299,0,14,93,148,93,148,0,14,29,45,29,45,0,14,411,177
86000US33947,"33947",9096,675,7470,660,6245,651,6245,651,0,19,233,165,221,160,12,19,992,427,967,422,25,40,1626,312
86000US33948,"33948",16913,1022,14091,1021,10633,873,10552,871,81,54,1025,326,952,312,73,76,2433,634,2272,602,161,104,2822,452
86000US33950,"33950",23128,709,17851,848,15267,744,15205,749,62,62,693,291,671,283,22,27,1891,501,1879,497,12,16,5277,544
86000US33952,"33952",33108,1406,24961,1456,18663,1497,18459,1464,204,190,1795,603,1682,576,113,81,4503,809,4209,764,294,130,8147,770
86000US33953,"33953",6741,816,5614,823,4571,678,4452,656,119,131,315,220,308,217,7,13,728,449,626,389,102,127,1127,331
86000US33954,"33954",10452,1088,8744,1169,7644,1197,7413,1177,231,168,226,272,226,272,0,21,874,379,813,354,61,84,1708,519
86000US33955,"33955",9995,783,8447,819,6825,730,6747,707,78,109,388,286,375,277,13,23,1234,614,1154,598,80,97,1548,293
86000US33956,"33956",3489,411,2808,408,2231,349,2231,349,0,14,409,283,335,234,74,55,168,131,168,131,0,14,681,191
86000US33957,"33957",7304,28,6152,197,5225,331,5225,331,0,19,500,190,389,162,111,48,427,193,427,193,0,19,1152,197
86000US33960,"33960",672,183,543,188,401,119,401,119,0,14,27,39,10,14,17,26,115,127,115,127,0,14,129,55
86000US33965,"33965",0,14,0,14,0,14,0,14,0,14,0,14,0,14,0,14,0,14,0,14,0,14,0,14
86000US33966,"33966",10054,989,8236,1011,6356,845,6251,810,105,101,436,304,389,289,47,78,1444,672,1444,672,0,21,1818,489
86000US33967,"33967",25114,1411,19828,1256,14643,1183,14599,1170,44,69,2101,739,1840,613,261,170,3084,862,2856,767,228,196,5286,763
86000US33971,"33971",27872,1555,25894,1651,16075,1308,15601,1205,474,234,2933,976,2463,824,470,250,6886,1345,6353,1194,533,247,1978,348
86000US33972,"33972",15495,1416,13952,1481,9191,1283,8928,1213,263,199,1833,912,1706,890,127,115,2928,922,2674,783,254,207,1543,354
86000US33973,"33973",17161,1295,16126,1427,7152,1228,7098,1209,54,93,2037,848,1755,769,282,154,6937,1166,6637,1121,300,177,1035,357
86000US33974,"33974",17741,1160,16218,1157,9086,765,8966,735,120,83,2034,586,1726,514,308,137,5098,932,4749,880,349,145,1523,385
86000US33976,"33976",18240,1267,17045,1402,10057,1249,9804,1230,253,204,2231,643,2014,618,217,102,4757,1118,4339,1023,418,185,1195,315
86000US33980,"33980",13047,1007,10121,1137,7355,1155,7355,1155,0,21,983,548,983,548,0,21,1783,588,1695,563,88,89,2926,414
86000US33981,"33981",11389,779,9516,873,7072,711,7053,709,19,30,700,422,580,346,120,126,1744,820,1505,651,239,227,1873,384
86000US33982,"33982",9626,815,8000,810,6362,774,6232,780,130,102,722,330,674,312,48,55,916,493,892,481,24,36,1626,384
86000US33983,"33983",14937,763,12832,826,10657,877,10604,869,53,75,410,356,345,287,65,73,1765,624,1691,608,74,69,2105,310
86000US33990,"33990",34420,1998,29889,2096,20349,2034,20287,2025,62,74,2073,884,1688,674,385,295,7467,1691,6943,1538,524,267,4531,672
86000US33991,"33991",22309,1638,19835,1765,14992,1569,14966,1565,26,30,1747,736,1483,628,264,172,3096,1056,2920,998,176,149,2474,434
86000US33993,"33993",27865,1968,25312,2087,18810,1679,18671,1722,139,202,3215,1222,2820,1084,395,195,3287,1069,2633,765,654,421,2553,479
86000US34101,"34101",0,14,0,14,0,14,0,14,0,14,0,14,0,14,0,14,0,14,0,14,0,14,0,14
86000US34102,"34102",11370,519,8373,547,6822,496,6762,489,60,55,479,215,454,202,25,25,1072,319,1043,313,29,26,2997,371
86000US34103,"34103",13021,872,10347,965,9023,876,8978,865,45,51,569,337,509,299,60,55,755,267,748,267,7,12,2674,372
86000US34104,"34104",24485,1510,19575,1524,14102,1200,13993,1171,109,118,1959,821,1731,749,228,156,3514,934,3066,713,448,414,4910,478
86000US34105,"34105",17924,1326,13779,1412,11849,1134,11826,1135,23,28,270,180,238,162,32,31,1660,798,1409,597,251,238,4145,630
86000US34108,"34108",16436,765,12453,705,10764,652,10681,651,83,67,766,400,668,345,98,81,923,373,860,355,63,54,3983,516
86000US34109,"34109",24164,1410,19825,1539,15594,1275,15507,1273,87,116,1468,874,1430,850,38,62,2763,887,2644,837,119,111,4339,496
86000US34110,"34110",23661,1265,19280,1421,15890,1216,15664,1213,226,202,926,468,810,411,116,95,2464,776,2128,700,336,172,4381,485
86000US34112,"34112",25926,1328,20183,1342,14984,1140,14759,1131,225,164,1236,466,1192,440,44,39,3963,949,3525,805,438,304,5743,540
86000US34113,"34113",21885,1278,17849,1130,14363,1454,14175,1442,188,153,1047,895,917,749,130,155,2439,846,2288,785,151,141,4036,637
86000US34114,"34114",17883,1042,15124,1035,10697,847,10697,847,0,21,1278,737,1142,645,136,109,3149,754,2652,600,497,240,2759,355
86000US34116,"34116",36052,1829,32333,1986,19340,1803,18732,1798,608,337,3904,1216,3428,1060,476,245,9089,1539,8136,1394,953,406,3719,664
86000US34117,"34117",17031,1162,16258,1175,12079,1420,11695,1367,384,324,2089,1058,1987,1032,102,79,2090,935,1800,833,290,343,773,221
86000US34119,"34119",32827,1886,28364,2002,23231,1671,22995,1683,236,194,1452,836,1173,631,279,280,3681,1290,3243,965,438,591,4463,810
86000US34120,"34120",35498,2307,33180,2435,26198,2805,26064,2794,134,188,2621,1275,2215,1139,406,292,4361,1743,3932,1581,429,289,2318,692
86000US34134,"34134",14992,915,11807,952,10409,803,10323,805,86,82,720,406,695,396,25,25,678,358,678,358,0,21,3185,337
86000US34135,"34135",47322,921,39895,1144,31404,1978,31192,1943,212,175,3734,1372,3205,1147,529,360,4757,1667,4442,1572,315,249,7427,806
86000US34137,"34137",651,409,611,415,611,415,611,415,0,14,0,14,0,14,0,14,0,14,0,14,0,14,40,46
86000US34138,"34138",340,356,291,348,198,317,198,317,0,14,93,150,93,150,0,14,0,14,0,14,0,14,49,78
86000US34139,"34139",204,82,146,77,141,79,141,79,0,14,5,9,3,7,2,3,0,14,0,14,0,14,58,33
86000US34140,"34140",337,328,211,267,211,267,211,267,0,14,0,14,0,14,0,14,0,14,0,14,0,14,126,203
86000US34141,"34141",36,48,36,48,36,48,36,48,0,14,0,14,0,14,0,14,0,14,0,14,0,14,0,14
86000US34142,"34142",29133,1728,25088,2065,12953,1768,12734,1723,219,149,3792,993,2830,709,962,386,8343,1340,7491,1167,852,340,4045,848
86000US34145,"34145",17829,33,14670,402,13449,567,13369,567,80,100,363,284,363,284,0,21,858,450,780,436,78,65,3159,402
86000US34201,"34201",3997,541,3314,580,2757,534,2757,534,0,14,62,96,62,96,0,14,495,306,473,292,22,34,683,201
86000US34202,"34202",24623,1023,21779,1056,19222,1024,19222,1024,0,25,854,480,713,398,141,93,1703,612,1632,580,71,113,2844,473
86000US34203,"34203",38851,2138,32229,2018,23236,1862,22646,1801,590,170,2110,951,1565,569,545,433,6883,1592,6557,1568,326,177,6622,850
86000US34205,"34205",31820,1129,24189,1411,14068,1257,13706,1183,362,252,3489,886,2920,737,569,250,6632,1022,6001,948,631,233,7631,696
86000US34207,"34207",36171,1947,28272,2015,15830,1595,15515,1560,315,200,4246,1048,3477,899,769,330,8196,1395,7022,1139,1174,490,7899,754
86000US34208,"34208",40544,1628,34870,1806,21267,1976,20665,1893,602,304,3147,882,2729,786,418,193,10456,1489,9911,1385,545,255,5674,904
86000US34209,"34209",34648,1243,27310,1260,20318,1313,20267,1318,51,41,1715,662,1494,580,221,171,5277,1050,4869,956,408,239,7338,648
86000US34210,"34210",16013,1009,11935,1016,8157,958,8118,949,39,46,971,548,873,498,98,71,2807,756,2597,682,210,104,4078,615
86000US34211,"34211",8898,1210,7772,1197,7278,1189,7278,1189,0,19,307,270,307,270,0,19,187,222,187,222,0,19,1126,418
86000US34212,"34212",21227,1192,19135,1252,14731,1533,14702,1524,29,47,1870,1021,1860,1020,10,17,2534,1093,2141,918,393,295,2092,543
86000US34215,"34215",567,222,490,206,413,215,413,215,0,14,0,14,0,14,0,14,77,113,62,90,15,23,77,92
86000US34216,"34216",719,174,566,155,494,135,494,135,0,14,0,14,0,14,0,14,72,78,72,78,0,14,153,59
86000US34217,"34217",5062,144,3661,303,3022,377,3012,377,10,13,245,251,181,181,64,79,394,181,325,136,69,70,1401,282
86000US34219,"34219",24514,1139,21958,1216,19708,1266,19655,1257,53,60,736,346,709,330,27,31,1514,486,1456,471,58,56,2556,571
86000US34221,"34221",44947,1674,38576,1754,25888,1678,25558,1688,330,184,3657,865,3279,784,378,200,9031,1710,8337,1514,694,340,6371,752
86000US34222,"34222",11650,1134,9503,1196,8089,1286,8045,1272,44,76,39,64,39,64,0,21,1375,516,1307,494,68,51,2147,452
86000US34223,"34223",18311,979,13611,1015,11666,875,11638,874,28,36,581,346,464,274,117,81,1364,478,1322,462,42,47,4700,422
86000US34224,"34224",16307,881,11977,1012,9636,985,9458,975,178,107,381,217,370,213,11,19,1960,717,1635,592,325,246,4330,614
86000US34228,"34228",7283,29,5945,190,5844,186,5775,187,69,66,0,19,0,19,0,19,101,76,101,76,0,19,1338,189
86000US34229,"34229",7674,669,6772,710,5906,726,5850,722,56,58,154,206,154,206,0,19,712,423,640,378,72,72,902,203
86000US34231,"34231",29910,1053,21130,1237,15181,1012,15023,969,158,134,1464,587,1283,488,181,124,4485,866,4104,811,381,146,8780,659
86000US34232,"34232",34904,1344,26892,1389,18699,1333,18476,1308,223,127,2850,680,2469,600,381,139,5343,700,4690,635,653,213,8012,838
86000US34233,"34233",17680,944,13373,920,10715,1041,10648,1030,67,62,639,309,546,257,93,76,2019,671,1842,613,177,113,4307,623
86000US34234,"34234",21154,1430,15600,1521,7724,970,7689,967,35,40,1377,589,1309,576,68,58,6499,1108,6207,1053,292,177,5554,534
86000US34235,"34235",15183,1166,11932,1230,8356,1081,8323,1086,33,41,1269,594,1129,488,140,153,2307,696,2142,648,165,127,3251,420
86000US34236,"34236",12370,663,7256,557,6043,569,5807,535,236,230,335,189,304,167,31,46,878,268,878,268,0,21,5114,477
86000US34237,"34237",16871,1004,12361,1095,7951,1100,7814,1077,137,142,753,389,694,348,59,52,3657,721,3303,593,354,243,4510,551
86000US34238,"34238",19849,846,15358,953,13100,873,13086,875,14,22,496,297,496,297,0,25,1762,584,1652,563,110,133,4491,446
86000US34239,"34239",15493,765,11204,787,8826,833,8727,798,99,78,810,326,737,303,73,56,1568,415,1483,392,85,69,4289,505
86000US34240,"34240",11442,999,10465,961,8922,909,8783,880,139,172,178,150,167,139,11,18,1365,589,1246,534,119,89,977,242
86000US34241,"34241",15568,968,13732,996,11841,917,11755,921,86,71,541,346,412,274,129,111,1350,488,1271,457,79,62,1836,314
86000US34242,"34242",7465,495,5758,488,5078,449,5052,453,26,35,341,237,271,181,70,71,339,214,325,207,14,22,1707,246
86000US34243,"34243",30965,1822,24106,1892,18790,1662,18593,1638,197,158,975,408,852,353,123,112,4341,1000,4201,977,140,101,6859,757
86000US34251,"34251",7034,1165,6558,1156,5716,1175,5533,1162,183,118,140,112,130,105,10,16,702,491,629,480,73,49,476,184
86000US34266,"34266",28766,840,24698,932,16303,1255,16072,1236,231,127,2384,732,2131,660,253,143,6011,939,5625,932,386,158,4068,618
86000US34268,"34268",157,154,157,154,80,110,80,110,0,14,0,14,0,14,0,14,77,114,77,114,0,14,0,14
86000US34269,"34269",4499,469,3540,466,2992,459,2951,443,41,32,86,73,86,73,0,14,462,250,448,243,14,25,959,247
86000US34275,"34275",20472,1112,16142,1177,12996,1161,12885,1170,111,140,1082,473,953,428,129,99,2064,827,1911,763,153,126,4330,510
86000US34285,"34285",18298,795,12684,949,10270,859,10147,876,123,85,608,265,575,241,33,54,1806,662,1770,655,36,39,5614,562
86000US34286,"34286",20178,1914,18283,2050,13391,1994,13391,1994,0,25,889,652,868,644,21,35,4003,1550,3825,1478,178,187,1895,690
86000US34287,"34287",28478,1521,23177,1556,15689,1224,15615,1218,74,72,1823,680,1577,585,246,180,5665,1003,4967,843,698,396,5301,824
86000US34288,"34288",11511,1460,9968,1673,8208,1697,8208,1697,0,21,556,479,345,268,211,229,1204,918,1169,909,35,67,1543,607
86000US34289,"34289",3481,1177,3119,1201,2139,969,2089,939,50,77,0,14,0,14,0,14,980,769,884,779,96,157,362,264
86000US34291,"34291",5626,965,5078,1023,3860,972,3834,968,26,41,283,283,237,231,46,66,935,622,900,605,35,42,548,225
86000US34292,"34292",15172,848,12009,833,10951,787,10862,774,89,88,282,253,282,253,0,21,776,326,745,317,31,37,3163,419
86000US34293,"34293",39483,1283,32012,1378,26560,1409,26307,1391,253,126,1357,404,1251,377,106,71,4095,700,3710,633,385,142,7471,663
86000US34420,"34420",17703,1444,15232,1642,8880,1449,8880,1449,0,21,1463,692,1138,552,325,304,4889,1406,4291,1276,598,296,2471,431
86000US34428,"34428",9043,1032,7182,1117,4980,980,4980,980,0,19,600,393,570,382,30,36,1602,714,1402,620,200,140,1861,413
86000US34429,"34429",8010,867,6069,848,4415,774,4415,774,0,19,502,365,400,274,102,125,1152,401,1081,397,71,82,1941,399
86000US34431,"34431",7997,813,6467,861,4189,525,4106,493,83,94,1003,472,879,408,124,72,1275,544,1186,509,89,91,1530,329
86000US34432,"34432",12493,935,10437,965,7914,937,7896,937,18,24,610,293,516,254,94,90,1913,655,1619,535,294,227,2056,274
86000US34433,"34433",6574,838,5377,816,3819,733,3782,735,37,65,165,235,123,174,42,62,1393,653,1378,650,15,28,1197,320
86000US34434,"34434",8013,801,6740,820,4126,810,4126,810,0,19,540,430,451,343,89,103,2074,796,1942,772,132,116,1273,330
86000US34436,"34436",8005,705,6202,718,4542,627,4474,632,68,77,570,293,523,265,47,49,1090,447,970,406,120,81,1803,297
86000US34442,"34442",14623,865,11733,879,9082,925,9002,917,80,70,1508,566,1317,494,191,105,1143,480,1061,443,82,60,2890,498
86000US34445,"34445",0,14,0,14,0,14,0,14,0,14,0,14,0,14,0,14,0,14,0,14,0,14,0,14
86000US34446,"34446",17454,1125,14566,1172,11992,1262,11825,1216,167,136,885,383,826,358,59,60,1689,551,1634,513,55,73,2888,408
86000US34448,"34448",10288,897,7760,942,5347,878,5347,878,0,21,666,388,511,286,155,156,1747,553,1574,522,173,117,2528,420
86000US34449,"34449",3139,340,2270,378,1339,325,1243,297,96,62,197,128,195,128,2,3,734,327,652,323,82,61,869,190
86000US34450,"34450",10617,822,7965,863,5667,746,5628,749,39,56,766,458,712,444,54,43,1532,569,1500,563,32,33,2652,409
86000US34452,"34452",11676,611,9370,700,7105,742,7073,746,32,41,513,320,434,281,79,70,1752,478,1660,473,92,54,2306,392
86000US34453,"34453",10488,863,8280,880,5549,766,5519,749,30,48,1523,671,1304,576,219,140,1208,461,1123,431,85,71,2208,356
86000US34461,"34461",9894,954,7494,1044,5913,1037,5861,1027,52,57,318,232,318,232,0,21,1263,645,1164,571,99,125,2400,548
86000US34465,"34465",17427,1152,14074,1272,9912,1210,9850,1204,62,62,773,386,603,302,170,111,3389,796,3009,712,380,186,3353,422
86000US34470,"34470",19370,1123,15169,1293,8975,946,8930,942,45,42,1256,500,1042,423,214,133,4938,972,4490,825,448,263,4201,544
86000US34471,"34471",25162,1608,20396,1597,14967,1646,14762,1629,205,197,1449,731,1277,660,172,135,3980,830,3755,803,225,145,4766,599
86000US34472,"34472",31297,1787,27628,1807,18235,1867,18193,1883,42,55,1499,748,1226,541,273,336,7894,1402,7319,1317,575,237,3669,499
86000US34473,"34473",19990,2061,18535,2110,13240,2180,13134,2168,106,96,981,567,848,509,133,171,4314,1317,4059,1234,255,202,1455,370
86000US34474,"34474",16675,1467,13195,1621,8236,1484,8124,1467,112,93,780,479,767,474,13,19,4179,1112,3552,917,627,307,3480,539
86000US34475,"34475",11454,1152,9165,1252,3657,682,3583,665,74,98,602,356,499,288,103,78,4906,1107,4517,997,389,222,2289,463
86000US34476,"34476",23279,1162,19468,1202,15579,1381,15388,1369,191,170,946,551,864,448,82,129,2943,809,2788,788,155,160,3811,393
86000US34479,"34479",13520,941,11290,1023,6994,985,6941,976,53,65,1322,666,1238,625,84,84,2974,826,2889,807,85,84,2230,460
86000US34480,"34480",19157,1287,16477,1364,12586,1298,12431,1245,155,172,1747,747,1461,570,286,276,2144,881,1781,781,363,331,2680,512
86000US34481,"34481",20931,1211,16423,1312,13783,1276,13774,1276,9,15,655,466,569,403,86,89,1985,595,1946,592,39,45,4508,584
86000US34482,"34482",18889,1648,15459,1746,10205,1274,10138,1258,67,77,1340,662,1066,501,274,211,3914,1137,3475,1010,439,315,3430,1135
86000US34484,"34484",3637,651,2629,597,2309,594,2309,594,0,14,120,95,120,95,0,14,200,159,200,159,0,14,1008,451
86000US34488,"34488",10369,920,8636,944,6316,760,6276,751,40,46,881,572,693,445,188,145,1439,494,1318,452,121,106,1733,323
86000US34491,"34491",26577,1903,21661,1959,17247,1754,17181,1749,66,82,1721,893,1603,835,118,98,2693,994,2481,944,212,149,4916,641
86000US34498,"34498",582,129,472,134,307,109,303,107,4,7,16,25,16,25,0,14,149,90,149,90,0,14,110,41
86000US34601,"34601",22029,977,17499,1037,12184,1134,12115,1143,69,54,926,378,793,313,133,74,4389,740,4003,663,386,190,4530,477
86000US34602,"34602",7599,783,6405,982,4789,1020,4581,915,208,161,1064,608,806,456,258,162,552,214,497,199,55,51,1194,555
86000US34604,"34604",11495,664,9903,745,7331,702,7309,696,22,33,567,374,409,223,158,166,2005,556,1855,505,150,78,1592,241
86000US34606,"34606",27104,1101,21798,1277,15077,1344,15033,1328,44,42,2672,727,2362,638,310,152,4049,755,3682,684,367,121,5306,601
86000US34607,"34607",8403,520,6988,604,5563,624,5563,624,0,19,342,203,284,164,58,69,1083,422,1055,406,28,37,1415,240
86000US34608,"34608",34496,1379,29029,1502,19341,1489,19226,1488,115,58,2818,890,2582,814,236,136,6870,984,6305,882,565,207,5467,683
86000US34609,"34609",42194,1044,37262,1275,27735,1635,27538,1626,197,118,2807,718,2405,617,402,167,6720,1141,6023,1016,697,249,4932,571
86000US34610,"34610",14671,870,12530,942,9261,867,9139,850,122,80,1038,483,882,413,156,110,2231,676,2023,600,208,133,2141,371
86000US34613,"34613",17917,908,14093,1001,10692,938,10622,927,70,66,1071,492,882,395,189,161,2330,622,2018,541,312,137,3824,466
86000US34614,"34614",7195,561,6234,619,5264,576,5182,557,82,99,324,271,248,190,76,86,646,276,631,264,15,23,961,280
86000US34637,"34637",5922,442,5174,478,3917,509,3879,504,38,43,263,218,225,185,38,42,994,542,911,512,83,97,748,233
86000US34638,"34638",28574,983,26632,1125,20883,1278,20787,1263,96,67,1510,645,1384,612,126,119,4239,895,3883,815,356,233,1942,328
86000US34639,"34639",29273,1259,26347,1318,20523,1277,20399,1269,124,87,1220,425,1102,385,118,74,4604,881,4372,845,232,101,2926,495
86000US34652,"34652",23525,947,18157,961,12715,1021,12532,1002,183,113,1623,473,1403,407,220,100,3819,640,3574,599,245,81,5368,532
86000US34653,"34653",33634,1381,26013,1580,17011,1690,16706,1629,305,315,2570,668,2298,583,272,164,6432,968,6106,927,326,131,7621,644
86000US34654,"34654",22930,1173,18573,1422,13693,1205,13544,1189,149,100,909,523,786,439,123,123,3971,793,3686,743,285,153,4357,544
86000US34655,"34655",41779,1264,35460,1405,28653,1513,28508,1490,145,73,1688,563,1590,531,98,63,5119,923,4723,862,396,137,6319,546
86000US34661,"34661",104,109,90,109,20,31,20,31,0,14,0,14,0,14,0,14,70,107,70,107,0,14,14,21
86000US34667,"34667",32632,1350,24364,1456,16744,1160,16376,1128,368,239,2079,614,1858,562,221,103,5541,946,5101,853,440,178,8268,579
86000US34668,"34668",48101,1457,37173,1708,22294,1666,22098,1640,196,143,3682,798,3197,673,485,180,11197,1360,10448,1310,749,223,10928,880
86000US34669,"34669",13213,751,11099,831,7647,833,7557,831,90,70,1217,412,1063,338,154,103,2235,479,2068,442,167,98,2114,331
86000US34677,"34677",22057,582,18331,685,12945,811,12862,807,83,65,1776,562,1491,436,285,189,3610,738,3480,714,130,90,3726,411
86000US34679,"34679",43,36,21,33,21,33,21,33,0,14,0,14,0,14,0,14,0,14,0,14,0,14,22,21
86000US34681,"34681",721,392,602,386,602,386,602,386,0,14,0,14,0,14,0,14,0,14,0,14,0,14,119,134
86000US34683,"34683",33458,1378,27960,1514,22473,1470,22380,1470,93,72,1999,616,1683,522,316,146,3488,692,3315,658,173,93,5498,563
86000US34684,"34684",28630,1046,22583,1216,17581,1181,17302,1176,279,255,1297,413,1158,364,139,87,3705,822,3502,778,203,149,6047,516
86000US34685,"34685",17991,933,15450,1053,13395,1043,13283,1017,112,87,458,265,434,256,24,27,1597,418,1532,405,65,48,2541,373
86000US34688,"34688",7407,679,6247,651,5111,546,5048,540,63,66,377,349,371,349,6,8,759,348,721,340,38,53,1160,244
86000US34689,"34689",26993,502,21711,1046,15123,1180,15055,1171,68,58,959,478,871,447,88,54,5629,908,5280,862,349,198,5282,923
86000US34690,"34690",11376,710,8677,766,4777,601,4712,593,65,42,909,351,813,318,96,62,2991,548,2768,518,223,129,2699,260
86000US34691,"34691",20236,1117,15697,1238,10717,1065,10671,1064,46,47,1316,433,1184,405,132,77,3664,709,3466,657,198,86,4539,509
86000US34695,"34695",18208,267,15103,519,11184,784,11013,779,171,101,1463,612,1293,543,170,110,2456,656,2298,630,158,80,3105,469
86000US34698,"34698",38111,959,27330,1285,21129,1459,21052,1447,77,59,1461,480,1251,414,210,120,4740,1060,4411,945,329,175,10781,904
86000US34705,"34705",2860,521,2484,517,1786,473,1767,469,19,21,368,191,308,158,60,49,330,157,288,134,42,42,376,170
86000US34711,"34711",61371,1669,54641,1988,44091,2364,43774,2311,317,237,2523,945,2236,825,287,189,8027,1680,7454,1568,573,334,6730,1065
86000US34714,"34714",22380,1997,18647,2159,11815,2034,11648,2012,167,140,1165,769,1079,720,86,134,5667,2209,4938,1973,729,341,3733,776
86000US34715,"34715",17038,1057,15743,1076,12276,1352,12114,1302,162,218,1168,597,1001,496,167,133,2299,996,2154,955,145,112,1295,415
86000US34731,"34731",14858,632,12198,758,8559,694,8439,687,120,85,815,352,636,258,179,120,2824,706,2672,653,152,116,2660,441
86000US34734,"34734",4580,913,4274,940,3492,856,3492,856,0,14,217,240,217,240,0,14,565,349,529,331,36,57,306,153
86000US34736,"34736",19218,1164,16372,1525,11258,1534,11179,1525,79,92,2608,1220,2390,1121,218,186,2506,877,2288,788,218,159,2846,838
86000US34737,"34737",2942,481,2533,487,1968,367,1960,366,8,13,354,397,341,397,13,14,211,156,194,131,17,33,409,110
86000US34739,"34739",243,159,90,121,8,11,8,11,0,14,0,14,0,14,0,14,82,119,72,103,10,17,153,98
86000US34741,"34741",47188,1990,37809,2178,22069,2138,21786,2170,283,225,2889,844,2362,647,527,320,12851,1404,12036,1325,815,225,9379,884
86000US34743,"34743",45109,2329,41532,2518,24670,2388,23731,2157,939,723,3849,1147,3276,915,573,291,13013,2123,12076,1924,937,661,3577,652
86000US34744,"34744",56603,2989,52169,3021,34573,3078,34429,3079,144,110,5238,1607,4503,1311,735,490,12358,2353,11540,2174,818,369,4434,542
86000US34746,"34746",44143,2874,38652,2904,25457,2716,25209,2735,248,158,3166,1035,2770,914,396,205,10029,2378,9370,2261,659,291,5491,972
86000US34747,"34747",21354,1682,16460,1646,13620,1602,13408,1582,212,196,882,448,792,419,90,116,1958,584,1801,536,157,99,4894,910
86000US34748,"34748",39536,1087,31687,1273,22733,1100,22640,1104,93,69,2002,652,1702,527,300,167,6952,1031,6594,982,358,172,7849,704
86000US34753,"34753",5899,313,5205,437,3299,674,3299,674,0,19,720,476,701,472,19,23,1186,648,889,488,297,246,694,275
86000US34756,"34756",3505,481,3200,481,2770,456,2755,456,15,14,100,99,89,87,11,19,330,175,318,172,12,16,305,116
86000US34758,"34758",43132,3157,40892,3176,25720,2946,25540,2943,180,154,4325,1457,3898,1393,427,299,10847,2604,10005,2465,842,399,2240,574
86000US34759,"34759",40704,2727,36743,2769,25828,2659,25662,2678,166,186,2877,1362,2579,1207,298,213,8038,2070,7420,1882,618,351,3961,1068
86000US34760,"34760",863,197,754,214,575,226,554,213,21,32,0,14,0,14,0,14,179,144,144,119,35,37,109,64
86000US34761,"34761",45652,1282,41157,1581,30170,2072,29746,2081,424,218,2944,816,2423,655,521,282,8043,1463,6982,1259,1061,385,4495,793
86000US34762,"34762",544,262,490,253,417,241,417,241,0,14,29,46,29,46,0,14,44,72,44,72,0,14,54,71
86000US34769,"34769",24572,1714,20505,1753,13602,1598,13432,1566,170,118,2027,748,1474,563,553,245,4876,1367,4697,1300,179,117,4067,549
86000US34771,"34771",21039,1918,19668,1947,16204,1954,16035,1916,169,150,1046,618,998,606,48,48,2418,859,2223,794,195,98,1371,353
86000US34772,"34772",31321,1690,28921,1777,22515,2112,22138,2084,377,282,1922,766,1757,711,165,126,4484,1133,4143,1042,341,200,2400,486
86000US34773,"34773",3728,860,3349,922,2714,864,2666,835,48,89,210,260,165,206,45,55,425,302,312,196,113,137,379,245
86000US34785,"34785",30981,1310,25083,1444,21915,1365,21828,1357,87,59,1080,472,930,406,150,109,2088,602,2080,599,8,13,5898,548
86000US34786,"34786",45836,2961,41973,3018,36204,3151,35769,3110,435,201,2472,1046,2324,991,148,111,3297,991,3164,960,133,109,3863,915
86000US34787,"34787",69476,2867,60414,2980,47950,2976,47621,2963,329,203,2960,1142,2721,1125,239,156,9504,1831,8513,1554,991,616,9062,1516
86000US34788,"34788",18164,1074,14110,1174,11464,1180,11270,1117,194,155,886,369,791,321,95,80,1760,555,1640,511,120,74,4054,469
86000US34797,"34797",1041,301,961,309,787,293,766,295,21,35,85,123,65,93,20,29,89,137,66,101,23,36,80,68
86000US34945,"34945",3976,463,3542,504,2894,406,2884,402,10,30,277,165,269,159,8,12,371,274,371,274,0,19,434,144
86000US34946,"34946",6019,699,4371,680,2961,545,2954,544,7,8,255,134,243,131,12,13,1155,541,1120,535,35,50,1648,288
86000US34947,"34947",13980,1455,12092,1505,6362,1373,6362,1373,0,21,822,425,751,367,71,94,4908,1214,4663,1135,245,198,1888,472
86000US34949,"34949",7654,579,5549,639,5031,602,5031,602,0,19,241,161,224,145,17,27,277,194,277,194,0,19,2105,331
86000US34950,"34950",16299,1322,13210,1449,5484,1249,5269,1214,215,237,2242,1016,1956,908,286,191,5484,1252,5206,1234,278,188,3089,487
86000US34951,"34951",17073,1180,13011,1179,9280,1178,9203,1173,77,73,1648,757,1563,721,85,110,2083,693,1915,613,168,122,4062,652
86000US34952,"34952",41079,1998,31859,2129,22663,1596,22532,1571,131,116,2604,854,2159,681,445,214,6592,1297,6120,1195,472,222,9220,815
86000US34953,"34953",70619,2587,64865,3140,49397,3404,48938,3421,459,257,3427,1118,3015,1058,412,191,12041,2497,11581,2434,460,211,5754,1079
86000US34956,"34956",8614,297,8008,372,3756,745,3681,735,75,84,1126,490,907,409,219,172,3126,742,2956,670,170,141,606,240
86000US34957,"34957",23106,1059,17186,994,13657,1035,13578,976,79,126,858,441,732,371,126,113,2671,611,2555,593,116,77,5920,566
86000US34972,"34972",17854,814,15678,907,10189,1001,10147,998,42,38,1672,626,1396,552,276,144,3817,902,3732,876,85,63,2176,457
86000US34974,"34974",23807,942,19439,1007,13420,888,13266,860,154,105,1845,456,1721,424,124,76,4174,672,3643,589,531,191,4368,456
86000US34981,"34981",5230,1242,4107,1124,2091,591,2091,591,0,19,782,582,664,504,118,119,1234,578,1163,549,71,79,1123,600
86000US34982,"34982",24962,1517,19890,1516,14603,1473,14438,1481,165,135,2304,732,1928,633,376,227,2983,788,2836,732,147,141,5072,714
86000US34983,"34983",42607,1865,38087,2042,27113,2548,26484,2422,629,372,3729,1273,3309,1164,420,278,7245,1542,6737,1403,508,249,4520,721
86000US34984,"34984",15999,851,14058,914,10261,916,10152,915,109,126,1272,705,1123,649,149,110,2525,660,2315,604,210,149,1941,352
86000US34986,"34986",28237,2600,22762,3004,16723,2287,16305,2122,418,578,945,1044,905,1036,40,64,5094,2312,5014,2301,80,111,5475,1016
86000US34987,"34987",9717,1506,8733,1611,7513,1382,7513,1382,0,19,557,515,470,426,87,109,663,449,663,449,0,19,984,337
86000US34990,"34990",29850,1253,25365,1348,22376,1484,22354,1483,22,39,795,432,699,378,96,103,2194,668,2174,667,20,23,4485,501
86000US34994,"34994",16994,853,12324,868,8099,993,8099,993,0,21,1027,426,956,391,71,71,3198,709,3008,688,190,109,4670,566
86000US34996,"34996",10685,551,7713,717,6510,660,6427,654,83,68,255,200,241,196,14,16,948,437,875,392,73,70,2972,407
86000US34997,"34997",44191,1358,35741,1669,25625,1657,25553,1657,72,88,2676,921,2228,773,448,223,7440,1262,7014,1216,426,230,8450,876
